   1	2   4   5 
   3	2   4   5 
   5	2   4   1 
   7	2   4   1 
   9	2   5   1 
  11	2   4   9 
  13	2   5   1 
  15	2   4   9 
  17	2   5   9 
  19	2   4   6 
  21	2   5   9 
  23	2   4   6 
  25	2   1   9 
  27	2   5   6 
  29	2   4   0 
  31	2   1   9 
  33	2   5   6 
  35	2   4   0 
  37	2   1   6 
  37	2   4   8 
  39	2   5   0 
  41	2   1   6 
  41	2   4   8 
  43	2   5   0 
  45	2   9   6 
  45	2   1   0 
  47	2   5   8 
  49	2   4  12 
  51	2   9   6 
  51	2   1   0 
  53	2   5   8 
  55	2   4  12 
  57	6   8   0 
  55	6  10   6 
  63	2   9   8 
  63	2   1   0 
  65	2   9   8 
  65	2   1   0 
  67	2  10   8 
  67	6   1   0 
  69	2  10   8 
  71	6  13   8 
  73	6   2   0 
  77	6  13  12 
  79	6   6   1 
  83	2   4   8 
  85	2   5  13 
  85	6   7   3 
  87	2   5  13 
  89	2   4   8 
  89	6  14  13 
  91	2   5   8 
  93	2   4   1 
  95	2   9   6 
  97	2   9   6 
  99	2   5   8 
  99	6  14  11 
 101	2   4   1 
 103	2   5   1 
 103	6  12   8 
 105	2  10   6 
 107	2  10   6 
 109	2   4   0 
 109	6   7   2 
 111	2   4   0 
 109	6  14  12 
 113	6   4   0 
 115	2   7  11 
 117	2   7  11 
 119	2   9  11 
 119	2   0   2 
 121	2   9  11 
 121	2   0   2 
 123	2   5   1 
 123	2  10  11 
 125	2   5   4 
 125	2  10  11 
 127	2   5   4 
 127	6  10   7 
 129	6   8   0 
 133	2  10  14 
 135	2  10  14 
 135	2   5   2 
 135	2   8  12 
 137	2   9  14 
 137	6   2   0 
 139	2   9  14 
 141	2   8  12 
 141	6  15  14 
 143	2   2   6 
 145	2   2   6 
 143	6  12   4 
 147	2   7  15 
 149	2   7  15 
 149	2   5   0 
 151	2   5   4 
 151	6   7   2 
 153	2   5   4 
 157	2   7  11 
 157	6   9   1 
 159	2   7  11 
 161	2   7  15 
 163	2  10   9 
 165	2  10   9 
 167	2   1   9 
 167	2   7  15 
 169	2   1   9 
 169	6  15   7 
 171	6   9   1 
 177	2   6  11 
 177	6  13  12 
 179	2   2   1 
 181	2   6  11 
 181	6   4   0 
 183	2  10  13 
 185	2  10  13 
 187	2   9  13 
 187	2   2   1 
 189	2   9  13 
 189	2   6   7 
 191	2   6   7 
 191	6   9   4 
 193	2  11   7 
 195	2  11   7 
 193	6   2   1 
 197	2  10   9 
 199	2  10   9 
 199	6   7   2 
 201	2   4   9 
 203	2   4   9 
 205	2  15   7 
 205	6   9   1 
 207	2  15   7 
 211	2   9  13 
 211	2   6   7 
 211	6   4   0 
 213	2   9  13 
 213	2   6   7 
 215	2  15  13 
 217	2   9   1 
 217	2  11   7 
 219	2  15  13 
 219	6   6   4 
 221	6  15  14 
 225	6   5   0 
 227	2  11   7 
 227	6  13  12 
 231	2  10   6 
 233	2  10   6 
 233	2   4  12 
 235	2   5   6 
 235	6  14  11 
 237	2   5   6 
 239	2   4  12 
 241	2   9   1 
 243	2   9   6 
 245	2   9   6 
 247	2   2   7 
 247	2  14  12 
 249	2   2   7 
 249	2  14  12 
 251	6   6   1 
 251	6  12   8 
 257	2  11   6 
 257	6   8   0 
 259	2  11   6 
 261	6  11   3 
 263	6   5   0 
 267	6  14  10 
 269	2   3   1 
 271	2   3   1 
 273	2   4   6 
 275	2   4   6 
 277	2   2   5 
 279	2  10   6 
 279	2   4   1 
 281	2   2   5 
 283	2  10   6 
 283	2   4   1 
 285	2   7   5 
 287	2   2   6 
 289	2   7   5 
 291	2   2   6 
 293	2   7   6 
 295	2   7   6 
 297	2   5   6 
 299	2   5   6 
 301	6   6   1 
 273	6  13  12 
 285	6  14  13 
 301	6   8   4 
 307	2  10   6 
 307	6   4   0 
 309	2  10   6 
 311	2   2   6 
 313	2   2   6 
 313	6   9   4 
 315	2   7   6 
 317	2   7   6 
 319	2   5   6 
 321	2   5   6 
 323	2   1   6 
 325	2   1   6 
 327	2   6  14 
 329	2   1   0 
 329	6  10   7 
 331	2   0   1 
 333	2   1   0 
 335	2   5  13 
 335	2   7   3 
 337	2  10   9 
 337	2   3   7 
 337	6   4   1 
 339	2   9  10 
 339	2   7   3 
 341	2  10   9 
 343	2   2   1 
 345	2   1   2 
 347	2  13   5 
 349	2  14   6 
 351	2   6  14 
 353	2   5  13 
 355	2   2   1 
