   1	2   3   1 
   3	2   3   1 
   5	2   3   4 
   7	2   3   4 
   9	2   1   4 
  11	2   3   7 
  13	2   1   4 
  15	2   3   7 
  17	2   1   7 
  19	2   3   5 
  21	2   1   7 
  23	2   3   5 
  25	2   4   7 
  27	2   1   5 
  29	2   4   7 
  31	2   1   5 
  33	2   4   5 
  35	2   4   5 
  37	2   7   5 
  39	2   7   5 
  41	2   5   3 
  43	2   7   1 
  45	2   1   7 
  47	2   3   5 
  49	2   5   3 
  51	2   7   1 
