   1	2   4   3 
   3	2   4   3 
   5	2   4   1 
   7	2   4   1 
   9	2   3   1 
  11	2   4   7 
  13	2   3   1 
  15	2   4   7 
  17	2   3   7 
  19	2   4   5 
  21	2   3   7 
  23	2   4   5 
  25	2   1   7 
  27	2   3   5 
  29	2   4   0 
  31	2   1   7 
  33	2   3   5 
  35	2   4   0 
  37	2   1   5 
  39	2   3   0 
  41	2   4   6 
  43	2   1   5 
  45	2   3   0 
  45	2   7   5 
  47	2   4   6 
  49	2   1   0 
  49	2   7   5 
  51	2   3   6 
  51	6   5   2 
  53	2   3   6 
  55	6   7   3 
  61	2   4   5 
  63	2   1   0 
  65	2   4   5 
  67	2   3   0 
  67	2   7   5 
  69	2   4   8 
  71	2   3   0 
  71	2   7   5 
  73	2   4   8 
  75	2   2   0 
  75	2   7   8 
  77	2   2   0 
  77	2   7   8 
  79	6   3   1 
  79	6   8   7 
  85	2   3   6 
  87	2   3   6 
  89	2   3   5 
  91	2   3   5 
  93	2   3   7 
  95	2   3   7 
  97	6   3   1 
 103	2   3   6 
 103	6   8   2 
 105	2   3   6 
 109	2   8   6 
 111	2   3   5 
 113	2   8   6 
 115	2   3   5 
 117	2   0   6 
 117	2   8   5 
 119	2   3   7 
 121	2   0   6 
 121	2   8   5 
 123	2   3   7 
 125	2   8   7 
 125	6   2   0 
 127	2   8   7 
 131	2   2   5 
 129	6   7   6 
 133	2   2   5 
 135	2   7   5 
 137	2   7   5 
 139	6   4   2 
 145	2   4   6 
 147	2   4   6 
 149	2   7   6 
 151	2   7   6 
 153	2   7   1 
 155	2   4   3 
 157	2   3   4 
 159	2   1   7 
 161	2   7   1 
 163	2   4   3 
 165	6   5   3 
 171	2   3   6 
 171	6   8   2 
 173	2   3   6 
 175	2   3   0 
 177	2   6   8 
 179	2   0   3 
 181	2   8   6 
 183	2   6   8 
 185	2   3   0 
