   1	2   4   5 
   3	2   4   5 
   5	2   4   1 
   7	2   4   1 
   9	2   5   1 
  11	2   4   9 
  13	2   5   1 
  15	2   4   9 
  17	2   5   9 
  19	2   4   6 
  21	2   5   9 
  23	2   4   6 
  25	2   1   9 
  27	2   5   6 
  29	2   4   0 
  31	2   1   9 
  33	2   5   6 
  35	2   4   0 
  37	2   1   6 
  37	2   4   8 
  39	2   5   0 
  41	2   1   6 
  41	2   4   8 
  43	2   5   0 
  45	2   9   6 
  45	2   1   0 
  47	2   5   8 
  49	2   4  12 
  51	2   9   6 
  51	2   1   0 
  53	2   5   8 
  55	2   4  12 
  57	6   8   0 
  55	6  10   6 
  63	2   9   8 
  63	2   1   0 
  65	2   9   8 
  65	2   1   0 
  67	2  10   8 
  67	6   1   0 
  69	2  10   8 
  71	6  13   8 
  73	6   2   0 
  77	6  13  12 
  79	6   6   1 
  83	2   4   8 
  85	2   5  13 
  87	2   5  13 
  89	2   4   8 
  89	6  10   2 
  95	2   9   6 
  97	2  10  13 
  97	2   4   1 
  99	2   5   8 
 101	2   9   6 
 103	2  10  13 
 103	2   4   1 
 105	2   5   8 
 107	2   2   6 
 107	2   9  13 
 107	2   4   0 
 109	2  10   8 
 111	2   5   1 
 111	6  14  12 
 113	2   2   6 
 113	2   4   0 
 115	2   5   1 
 117	2   9  13 
 117	6   2   1 
 119	2  10   8 
 121	2   9   8 
 123	2  14   6 
 123	6   4   0 
 125	2  10   2 
 127	2  14   6 
 129	2   5   4 
 131	2   9   8 
 131	6   6   1 
 133	6  14  13 
 137	2   5   4 
 139	2   6  14 
 139	6   8   4 
 141	2   6  14 
 143	2  10   2 
 145	2  13  14 
 145	2   6   4 
 147	2  10   8 
 149	2  13  14 
 149	2   6   4 
 151	2  10   8 
 153	6   9   1 
 159	2   1   2 
 159	2   9  14 
 161	2   1   2 
 161	2   9  14 
 163	2   6   2 
 163	6   8   4 
 165	2   6   2 
 167	6  10   2 
 173	2  13   8 
 175	2   1   4 
 175	6  14  12 
 177	2   1   4 
 179	6   5   4 
 185	2  13   8 
 185	2   6   5 
 187	2   9   8 
 189	2  13  10 
 191	2   9   8 
 193	2  13  10 
 195	2   6   5 
 195	2  12   8 
 197	2   9  10 
 199	2  13   5 
 201	2  12   8 
 203	2   9  10 
 205	2  13   5 
 207	2   9   5 
 209	2   9   5 
 211	2   9   6 
 213	2   6   9 
 215	2   9   6 
 217	6  10   8 
 223	2  12   8 
 225	2  12   8 
 227	2  10   8 
 229	2  10   8 
 231	6   8   5 
 237	2  12   8 
 239	2  12   8 
 237	6   6   1 
 241	6  14  12 
 247	2  10   8 
 249	2  10   8 
 251	2   5   8 
 253	2   5   8 
 255	2   8   0 
 255	2  14   6 
 257	2   5   4 
 259	2  10   2 
 261	2   6  14 
 261	2   0   8 
 263	2   2  10 
 265	2   4   5 
 267	2   8   0 
 267	2  14   6 
 269	2   5   4 
 271	2  10   2 
