   1	2   4   5 
   3	2   4   5 
   5	2   4   1 
   7	2   4   1 
   9	2   5   1 
  11	2   4   9 
  13	2   5   1 
  15	2   4   9 
  17	2   5   9 
  19	2   4   6 
  21	2   5   9 
  23	2   4   6 
  25	2   1   9 
  27	2   5   6 
  29	2   4   0 
  31	2   1   9 
  33	2   5   6 
  35	2   4   0 
  37	2   1   6 
  37	2   4   8 
  39	2   5   0 
  41	2   1   6 
  41	2   4   8 
  43	2   5   0 
  45	2   9   6 
  45	2   1   0 
  47	2   5   8 
  49	2   4  12 
  51	2   9   6 
  51	2   1   0 
  53	2   5   8 
  55	2   4  12 
  57	6   8   0 
  55	6  10   6 
  63	2   9   8 
  63	2   1   0 
  65	2   9   8 
  65	2   1   0 
  67	2  10   8 
  67	6   1   0 
  69	2  10   8 
  71	6  13   8 
  71	6  10   6 
  77	2   4   8 
  77	6   6   1 
  79	2   4   8 
  77	6  14  13 
  83	2   9   6 
  83	6   4   0 
  85	2   9   6 
  87	6  12   9 
  89	2   0   2 
  91	2   0   2 
  93	2   5   9 
  95	2   5   9 
  97	2   4   9 
  99	2   5   8 
 101	2   4   9 
 103	2   5   8 
 105	2   1   6 
 105	2   4   8 
 107	2  12   9 
 107	6   2   0 
 109	2  12   9 
 113	2   5   0 
 115	2   1   6 
 115	2   4   8 
 117	2   5   0 
 117	2  12   8 
 119	2  14   6 
 119	2   4   0 
 121	2   1   9 
 123	2  14   6 
 123	2  12   8 
 125	2   1   9 
 127	2   4   0 
 127	2  14   9 
 129	2  14   9 
 129	6   4   0 
 131	2   6   9 
 133	2   6   9 
 135	2  12   4 
 137	2  12   4 
 139	6   4   1 
 139	6  14  12 
 145	2   4   8 
 147	2   4   8 
 149	2  12   8 
 145	6  10   6 
 151	2   4   1 
 153	2  12   8 
 153	6   5   1 
 155	6  13  12 
 159	2   4   5 
 161	2  10   8 
 161	6   1   0 
 163	2  10   8 
 165	2   9   8 
 167	2  13   5 
 169	2  13   5 
 171	2  10   5 
 171	6  13  12 
 173	2  10   5 
 177	2   9   8 
 179	2   9   5 
 181	2   9   5 
 183	2   8   5 
 183	2  10  14 
 185	2   8   5 
 185	2  14  10 
 187	2   5   2 
 187	2  10  14 
 189	2   8   0 
 191	2   9   1 
 193	2  12   4 
 195	2   4  12 
 197	2   1   9 
 199	2   0   8 
 201	2   2   5 
 203	2   5   2 
 205	2   8   0 
 207	2   9   1 
 209	2  12   4 
