   1	2   4   3 
   3	2   4   3 
   5	2   4   1 
   7	2   4   1 
   9	2   3   1 
  11	2   4   7 
  13	2   3   1 
  15	2   4   7 
  17	2   3   7 
  19	2   4   5 
  21	2   3   7 
  23	2   4   5 
  25	2   1   7 
  27	2   3   5 
  29	2   4   0 
  31	2   1   7 
  33	2   3   5 
  35	2   4   0 
  37	2   1   5 
  39	2   3   0 
  41	2   4   6 
  43	2   1   5 
  45	2   3   0 
  45	2   7   5 
  47	2   4   6 
  49	2   1   0 
  49	2   7   5 
  51	2   3   6 
  51	6   5   2 
  53	2   3   6 
  55	6   7   3 
  61	2   4   5 
  63	2   1   0 
  65	2   4   5 
  67	2   3   0 
  67	2   7   5 
  69	2   3   0 
  69	2   7   5 
  71	2   2   0 
  73	2   2   0 
  75	6   3   1 
  81	2   3   6 
  83	2   3   6 
  85	2   3   5 
  87	2   3   5 
  89	6   3   1 
  95	2   3   6 
  95	6   8   2 
  97	2   3   6 
 101	2   8   6 
 103	2   3   5 
 105	2   8   6 
 107	2   3   5 
 109	2   0   6 
 109	2   8   5 
 111	2   0   6 
 111	2   8   5 
 113	6   5   3 
 119	2   0   3 
 119	2   8   5 
 121	2   0   3 
 121	2   5   8 
 123	2   6   3 
 123	2   8   5 
 125	2   6   3 
 127	2   3   4 
 129	2   6   7 
 129	2   0   1 
 131	2   1   0 
 131	2   7   6 
 133	2   4   3 
 135	2   3   4 
 137	2   6   7 
 137	2   0   1 
