   1	2   4   5 
   1	6   7   2 
   3	2   4   5 
   7	2   4   1 
   9	2   4   1 
  11	2   5   1 
  13	2   4   9 
  15	2   5   1 
  17	2   4   9 
  19	2   5   9 
  21	2   4   6 
  23	2   5   9 
  25	2   4   6 
  27	2   1   9 
  29	2   5   6 
  31	2   4   0 
  33	2   1   9 
  35	2   5   6 
  37	2   4   0 
  39	2   1   6 
  39	2   4   8 
  41	2   5   0 
  43	2   1   6 
  43	2   4   8 
  45	2   5   0 
  47	2   9   6 
  47	2   1   0 
  49	2   5   8 
  51	2   4  12 
  53	2   9   6 
  53	2   1   0 
  55	2   5   8 
  57	2   4  12 
  57	6   6   2 
  59	6   8   0 
  65	2   9   8 
  65	2   1   0 
  67	2   4   6 
  67	6  13  12 
  69	2   1   0 
  71	2   4   6 
  73	2   5  13 
  75	2   9   8 
  75	6   2   0 
  77	6  10   9 
  83	2   5  13 
  85	2   0   8 
  85	6  10   7 
  87	2   0   8 
  89	6   8   4 
  91	2   7   2 
  93	2   7   2 
  95	2   5   6 
  95	6  13   8 
  97	2   5   6 
  99	2   0   2 
 101	2  13   9 
 101	2   0   2 
 103	2  13   9 
 103	6   4   1 
 105	2  13  10 
 107	2  13  10 
 103	6   7   3 
 109	2   4   8 
 109	2   1   2 
 109	6  11   7 
 111	2   4   8 
 111	2   1   2 
 113	2   5   9 
 115	2   4   6 
 115	6  15  13 
 117	2   4   6 
 119	6   3   1 
 121	2  15  11 
 123	2  15  11 
 121	6  13  12 
 125	2  15   7 
 125	6   1   0 
 127	2  15   7 
 129	2  15  13 
 131	2   0   8 
 131	6  11   7 
 133	2   0   8 
 135	2   5   9 
 137	2   4   9 
 139	2   5  10 
 141	2   4   9 
 143	2   5  10 
 145	2   5   7 
 147	2   5   7 
 149	2  15  13 
 149	6   6   4 
 151	2  15  14 
 153	2  15  14 
 155	2   0   4 
 155	2   6  10 
 157	2   0   4 
 157	2   6  10 
 159	2   6   7 
 159	6   8   0 
 161	2   6   7 
 163	6  11   6 
 165	2   1   0 
 165	2   8   9 
 167	2   1   0 
 167	2   8   9 
 169	2   1   4 
 171	2   1   4 
 173	2   1   9 
 175	2   8  10 
 175	6   3   2 
 177	2   8  10 
 179	6  10   5 
 185	2   2   0 
 185	6  15  13 
 187	2   2   0 
 189	6   2   0 
 191	6  13   8 
 195	2   3   2 
 197	2   0   4 
 197	2  10   6 
 199	2   3   2 
 199	2   0   4 
 201	2   1   9 
 201	6  15   7 
 203	2   1   5 
 205	2   1   5 
 207	2  10   6 
 207	6   8   0 
 209	2  11   6 
 211	2  10   7 
 213	2   8   9 
 213	2  11   6 
 215	2  13  15 
 215	6   3   1 
 217	2   8   9 
 219	2  13  15 
 221	2   1   4 
 221	2  10   7 
 223	2   1   4 
 223	2  11   7 
 225	2   1   9 
 225	2  11   7 
 227	2   8   5 
 227	2  10  14 
 227	6   7   3 
 229	2   1   9 
 231	2   8   5 
 231	2  10  14 
 233	2   7  15 
 233	2   1   5 
 233	6  13   8 
 235	2   7  15 
 235	2   1   5 
 237	6   2   0 
 239	2  13  15 
 241	2  11  14 
 241	6   9   8 
 243	2  11  14 
 243	6   3   1 
 247	2  13  15 
 249	2   0   4 
 249	2   9   6 
 249	6  15  11 
 251	2   0   4 
 251	2   9   6 
 253	2   0   8 
 255	2   7   6 
 255	2   0   8 
 257	2   9   1 
 259	2   7   6 
 259	2   4   8 
 259	6  14  13 
 261	2   0   5 
 263	2   4   8 
 261	6   7   3 
 265	2   9   1 
 267	2   7  11 
 267	2   9  13 
 267	6   2   1 
 269	2   7  11 
 269	2   9  13 
 271	6  11   9 
 273	2   3   2 
 275	2   3   2 
 277	2  14   6 
 277	6   8   0 
 279	2  14   6 
 281	2   7   6 
 283	2   8   5 
 283	6  11   3 
 285	2   4   5 
 287	2   8   9 
 287	6   1   0 
 289	2   8   9 
 289	2   7   6 
 291	6  14  11 
 293	2   4   5 
 295	2   1   5 
 297	2  14  13 
 297	2   1   5 
 297	6  11   7 
 299	2  14  13 
 301	2   4   9 
 303	2   7   2 
 303	2   4   9 
 305	2   7   2 
 305	6  15  13 
 307	6   6   4 
 313	2   8   4 
 313	2   7  15 
 315	2   8   4 
 315	2   7  15 
 317	2   1   9 
 317	6  11   7 
 319	2   1   9 
 321	2   5   9 
 323	2   7   2 
 323	2   5   9 
 325	2   7   2 
 325	6   8   0 
 327	2   7  15 
 329	2   7  15 
 331	2   6   4 
 331	6  15  13 
 333	2   0   2 
 335	2   6   4 
 337	2   0   2 
 337	6  13   8 
 339	2   6   2 
 341	2   6   2 
 343	2   1   4 
 343	6  10   6 
 345	2   0   8 
 347	2   1   4 
 349	2   0   8 
 351	2   5   4 
 353	2   1   2 
 353	2  10   8 
 355	2   5   4 
 357	2   1   2 
 357	2  10   8 
 359	2   9   4 
 359	6   6   2 
 361	2   9   4 
 363	6   8   0 
 365	2  10   7 
 367	2   7  10 
 369	2   5   6 
 369	6  14  13 
 371	2   1   0 
 373	2   5   6 
 375	2   1   0 
 375	2   9   6 
 377	2   5   0 
 377	6  11   3 
 379	2   5   0 
 381	2   5  13 
 383	2   9   6 
 385	2   4   6 
 387	2   4   6 
 389	2   1   3 
 391	2   3   1 
 389	6   9   8 
 393	2   1   3 
 383	6  15  14 
 389	6  14  11 
 395	2   8   0 
 395	2  10   7 
 397	2   8   0 
 397	6  11  10 
 399	2   4   0 
 401	2   4   0 
 403	2  13   5 
 405	2   5  13 
 407	6   6   4 
 407	6  15  13 
 413	2   4   0 
 413	2   6  10 
 415	2   4   0 
 415	2  10   6 
 417	2   6  10 
 413	6  13  12 
 417	6   4   0 
 419	6  14   9 
 423	2   0   2 
 425	2   4  12 
 427	2   8   9 
 427	2   2   0 
 429	2   9   8 
 429	2   0   2 
 431	2  12   4 
 433	2   4  12 
 435	2   8   9 
