   1	2   4   5 
   3	2   4   5 
   5	2   4   1 
   7	2   4   1 
   9	2   5   1 
  11	2   4   9 
  13	2   5   1 
  15	2   4   9 
  17	2   5   9 
  19	2   4   6 
  21	2   5   9 
  23	2   4   6 
  25	2   1   9 
  27	2   5   6 
  29	2   4   0 
  31	2   1   9 
  33	2   5   6 
  35	2   4   0 
  37	2   1   6 
  37	2   4   8 
  39	2   5   0 
  41	2   1   6 
  41	2   4   8 
  43	2   5   0 
  45	2   9   6 
  45	2   1   0 
  47	2   5   8 
  49	2   4  12 
  51	2   9   6 
  51	2   1   0 
  53	2   5   8 
  55	2   4  12 
  57	6   8   0 
  55	6  10   6 
  63	2   9   8 
  63	2   1   0 
  65	2   9   8 
  65	2   1   0 
  67	2  10   8 
  67	6   1   0 
  69	2  10   8 
  71	6  13   8 
  73	6   2   0 
  77	6  13  12 
  79	6   6   1 
  83	2   4   8 
  85	2   5  13 
  85	6   7   3 
  87	2   5  13 
  89	2   4   8 
  89	6  14  13 
  91	2   5   8 
  93	2   4   1 
  95	2   9   6 
  97	2   9   6 
  99	2   5   8 
  99	6  14  11 
 101	2   4   1 
 103	2   5   1 
 103	6  12   8 
 105	2  10   6 
 107	2  10   6 
 109	2   4   0 
 109	6   7   2 
 111	2   4   0 
 109	6  14  12 
 113	6   4   0 
 115	2   7  11 
 117	2   7  11 
 119	2   9  11 
 119	2   0   2 
 121	2   9  11 
 121	2   0   2 
 123	2   5   1 
 123	2  10  11 
 125	2   5   4 
 125	2  10  11 
 127	2   5   4 
 127	6  10   7 
 129	6   5   1 
 133	2  10  14 
 135	2  10  14 
 135	2   1   2 
 135	6   8   4 
 137	2   1   2 
 137	6  11   7 
 141	2   9  14 
 143	2   4   6 
 145	2  10   5 
 147	2   4   6 
 149	2   9  14 
 149	6   7   6 
 151	6   9   4 
 157	2  10   5 
 159	2   9   6 
 161	2  11  14 
 161	2   4   5 
 163	2  10   8 
 165	2   9   6 
 167	2  11  14 
 167	2   4   5 
 169	2  10   8 
 171	2   7   6 
 171	2   9  14 
 173	2   4   8 
 173	2  10   2 
 175	2   7   6 
 175	2   9  14 
 177	2   4   8 
 177	2  10   2 
 179	6   7   5 
 179	6  14  13 
 185	2  11   7 
 185	2   5  13 
 187	2  11   7 
 187	2   5  13 
 189	6  11   9 
 189	6   2   0 
 195	2  11   7 
 195	2   9   8 
 197	2   4   0 
 197	2  11   7 
 199	2   9   8 
 199	6  11   6 
 201	2   4   0 
 201	6  14  13 
 205	2   5   7 
 207	2  11  14 
 207	6   8   0 
 209	2  11  14 
 207	6   6   2 
 213	2   2   0 
 213	2   9   8 
 211	6  15  14 
 215	2   5   7 
 217	2   2   0 
 217	2   9   8 
 219	2  11   7 
 219	2   5   0 
 221	2  11   7 
 221	2   5   0 
 223	2  15   7 
 223	6   8   5 
 225	2  15   7 
 227	6  11  10 
 229	2   2   5 
 231	2   2   5 
 233	2   8   5 
 235	2   8   5 
 237	6   5   0 
 233	6  15   7 
 239	6  15  13 
 243	6   2   0 
 249	2  10   5 
 251	2  10   5 
 253	2   7   5 
 255	2  10   2 
 257	2   7   5 
 259	2  10   2 
 261	2  13   5 
 263	2   7   2 
 263	2  10   9 
 265	2  13   5 
 267	2   7   2 
 267	2   8   0 
 269	2   0   8 
 269	6   6   2 
 271	2   8   0 
 275	2   9  10 
 275	6   4   1 
 277	2  10   9 
 275	6   7   3 
 279	6  13  10 
 281	2   3   1 
 283	2   1   3 
 285	2  10   6 
 287	2  10   6 
 289	2   5   6 
 291	2   5   6 
 293	2   6   2 
 295	2   5   4 
 295	2  10  11 
 297	2  11  10 
 297	2   4   5 
 299	2   2   6 
 301	2   6   2 
 303	2   5   4 
 303	2  10  11 
 305	2   3   1 
