   1	2   4   5 
   3	2   4   5 
   5	2   4   1 
   7	2   4   1 
   9	2   5   1 
  11	2   5   1 
  13	2   4   9 
  15	2   4   9 
  17	2   5   9 
  19	2   4   6 
  21	2   4   6 
  23	2   5   9 
  25	2   4   0 
  27	2   4   0 
  29	2   4   8 
  31	2   1   9 
  33	2   1   9 
  35	2   5   6 
  37	2   4   8 
  39	2   4  12 
  41	2   4  12 
  43	2   5   6 
  45	2   1   6 
  47	6  12   4 
  53	6  14  12 
  53	2   1   6 
  55	2   5   0 
  57	2   5   0 
  59	2   1   0 
  61	2   1   0 
  59	2   9   6 
  63	2   5   8 
  65	2   5   8 
  67	2   9   6 
  69	6   9   1 
  75	6   1   0 
  81	2   5   4 
  83	2   0   1 
  83	2   9   8 
  85	6   6   2 
  85	2   9   8 
  91	2   0   1 
  93	2   0   8 
  95	2   5   4 
  97	2   2   1 
  95	2  14  13 
  99	2   2   1 
  97	2   9   4 
  99	2   9   4 
 101	2   0   8 
 103	2   0   4 
 105	2   0   4 
 103	2  14  13 
 105	2  14  10 
 107	2   5  13 
 109	2   5  13 
 111	2  14  10 
 113	2  14   6 
 115	2  14   6 
 111	6   8   0 
 117	2   2   0 
 119	2   2   0 
 121	2   1   0 
 117	2   9  13 
 123	2   5  10 
 125	6   2   0 
 125	2   9  13 
 127	2   8  13 
 129	2   8  13 
 131	2   5  10 
 133	2   9  10 
 135	2   5   6 
 137	2   1   2 
 139	2   5   6 
 135	6  13   8 
 141	6   8   0 
 147	2   8   4 
 147	6  13  10 
 149	2   8   4 
 151	2   1   4 
 153	2   1   4 
 153	2   9  13 
 155	2   8   0 
 157	2   8   0 
 159	2   1   0 
 159	2  10  13 
 161	6   4   1 
 161	2  10  13 
 163	6  10   6 
 167	2   8  13 
 169	2   9  10 
 169	2   4   0 
 171	6  13   8 
 171	2   2   1 
 173	2   2   1 
 175	2   2   0 
 177	2   2   0 
 177	2  13   8 
 179	2   4   8 
 181	2   1   0 
 183	2   1   0 
 181	2   9  10 
 183	2   6  10 
 185	6   8   0 
 191	2   4   0 
 185	2   6  10 
 191	2  13  10 
 193	6  10   9 
 193	2   2   0 
 195	2   2   0 
 197	2   1   0 
 199	2  13   9 
 201	2   4   9 
 203	2   4   9 
 205	2   1   0 
 207	2   8   0 
 209	2   8   0 
 207	6   6   2 
 213	2   6   9 
 215	2   6   9 
 211	6   4   0 
 217	2   1   9 
 219	2   1   9 
 221	2   8   9 
 221	2   1   2 
 223	2   2   1 
 225	2   1   2 
 223	2   8   9 
 225	2   4   9 
 227	2   4   9 
 229	2   9  14 
 231	2   4   5 
 233	2   5   4 
 235	2   4   5 
 231	6  13  10 
 237	2   8  13 
 237	2   6  10 
 239	2  10   6 
 241	2   6  10 
 239	2  13   8 
 241	2   8  13 
 243	2  14   9 
 245	2   9  14 
