   1	2   4   5 
   3	2   4   5 
   5	2   4   1 
   7	2   4   1 
   9	2   5   1 
  11	2   5   1 
  13	2   4   9 
  15	2   4   9 
  17	2   5   9 
  19	2   4   6 
  21	2   4   6 
  23	2   4   0 
  25	2   4   0 
  27	2   5   9 
  29	2   1   9 
  31	2   1   9 
  33	6  12   4 
  33	6  10   2 
  39	2   5   6 
  39	2  12   8 
  41	2  12   8 
  43	2  12   4 
  45	2   5   6 
  47	2   5   0 
  49	2   5   0 
  51	2   1   6 
  53	2   1   6 
  55	2   9   6 
  55	2   1   0 
  57	2  12   4 
  59	2   5   8 
  61	2   1   0 
  61	2   9   6 
  63	6   9   1 
  69	2   1   0 
  71	2   1   0 
  69	2  12  13 
  71	2  12  13 
  73	6   8   5 
  79	2   8   5 
  73	6  14  10 
  81	2   9   5 
  83	6  14  12 
  83	6   2   0 
  89	2   6   2 
  89	2   8   4 
  91	2   9   5 
  93	2   6   2 
  93	2   8   4 
  95	2   9   4 
  97	2   1   5 
  97	2   8  13 
  99	2   1   5 
  99	2   8  13 
 101	2   9   4 
 103	2   1   4 
 103	2   9  13 
 105	6  13   9 
 105	2   1   4 
 111	2  13   9 
 107	6   2   0 
 113	2   6   5 
 115	2   6   5 
 113	2  14  12 
 115	2  14  12 
 117	2   6   4 
 119	2   6   4 
 121	2   1   9 
 123	2   1   9 
 125	2   8  12 
 125	2   0   5 
 127	2   8  12 
 127	2   0   5 
 129	2  13  12 
 131	2  13  12 
 129	2   0   4 
 131	2   0   4 
 133	6   5   0 
 133	6  12   8 
 139	2   0   4 
 141	2   0   4 
 139	2   6   9 
 141	2   6   9 
 143	2   5   9 
 145	2   5   9 
 147	6   4   1 
 153	2   4   8 
 155	2   4   8 
 157	6  10   8 
 163	2   6  10 
 165	2   6  10 
 157	6   1   0 
 163	6   8   0 
 169	2   1   9 
 171	2   1   9 
 173	2   8   9 
 175	2   8   9 
 177	2   5  10 
 179	2   5  10 
 181	2   5   6 
 183	6   9   1 
 189	2   9  10 
 191	2   9  10 
 193	2   8  10 
 195	2   8  10 
 189	6   2   1 
 197	2   2  10 
 199	2   2  10 
 201	2  10  14 
 203	2  14  10 
 205	2  10  14 
 197	6  12   4 
 207	2   8  13 
 209	2   9  12 
 211	2  12   9 
 213	2   9  12 
 203	6   2   0 
 209	2   0   4 
 211	2   4   0 
 213	2   0   4 
 215	2   6   5 
 217	2   5   6 
 215	2  13   8 
 217	2   8  13 
