   1	2   4   5 
   3	2   4   5 
   5	2   4   1 
   7	2   4   1 
   9	2   5   1 
  11	2   5   1 
  13	2   4   9 
  15	2   4   9 
  17	2   5   9 
  19	2   4   6 
  21	2   4   6 
  23	2   5   9 
  25	2   4   0 
  27	2   4   0 
  29	2   4   8 
  31	2   1   9 
  33	2   1   9 
  35	2   5   6 
  37	2   4   8 
  39	2   4  12 
  41	2   4  12 
  43	6  12   4 
  37	6  14  10 
  43	6  10   2 
  49	2   5   6 
  51	2   1   6 
  49	2  12  13 
  53	2   1   6 
  51	2  12  13 
  55	2   9   6 
  57	2   9   6 
  55	6   1   0 
  61	2   5   1 
  63	2   5   1 
  65	2   0   1 
  67	2   0   1 
  69	2   5   8 
  71	2   5   8 
  73	2   9   1 
  75	2   9   1 
  77	6  14  12 
  77	2   5   4 
  79	2   6   1 
  81	2   6   1 
  83	6   8   5 
  89	2   8   4 
  83	6  11   3 
  91	2   0   5 
  91	2  14  12 
  93	2  14  12 
  93	2   0   5 
  95	6  13   8 
 101	2   9   5 
 103	2   9   5 
 101	6  14  11 
 105	2   6   5 
 107	2   6   5 
 109	2   1   5 
 107	2  13   8 
 109	2  13   8 
 109	2  11  10 
 111	2   1   5 
 111	2  13  12 
 111	2  11  10 
 113	6   5   0 
 113	2  13  12 
 119	2   5   4 
 119	2  13  10 
 121	2   5   4 
 121	2  13  10 
 123	2   9   4 
 125	2   9   4 
 127	6   8   5 
 133	2   6   4 
 135	2   8   5 
 137	2   6   4 
 139	2   1   4 
 141	2   8   5 
 143	2   9   5 
 145	2   1   4 
 147	2   0   4 
 139	2  11  14 
 141	2  11  14 
 145	2  13  14 
 147	2  13  14 
 149	2   8  12 
 151	2   9   5 
 153	2   6   5 
 153	2   8  12 
 155	2   9  12 
 157	2   8  10 
 159	2   8  10 
 161	2   6   5 
 161	6  14  12 
 163	2   1   5 
 165	2   1   5 
 167	6   2   1 
 167	2   8  12 
 169	2   8  12 
 171	2   9  14 
 173	6  14   6 
 173	2   0   4 
 179	2  14   6 
 181	2   0   5 
 183	2   0   5 
 185	2  14   6 
 187	6   6   1 
 193	2   4   5 
 195	2   2   1 
 197	2   2   1 
 199	2   0   1 
 201	2   4   5 
 187	6  13  12 
 203	2   0   1 
 205	2   4   1 
 203	2   9  10 
 207	2   4   1 
 205	2   9  10 
 209	2   5   1 
 211	2   5   1 
 207	2  14  10 
 209	2  14  10 
 213	6   6   2 
 219	2   6  10 
 221	6  10   2 
 227	2   6   2 
 229	2   0   2 
 231	2   0   2 
 227	2   9  13 
 229	2   9  13 
 231	2  14  13 
 233	6   2   1 
 239	2   4   1 
 233	2  14  13 
 235	6  13   9 
 241	6   8   0 
 247	2   4   1 
 241	6  10   6 
 249	2   5   1 
 251	2   5   1 
 247	6  14  12 
 253	2   2   1 
 255	2   2   1 
 253	2  10   9 
 255	2  10   9 
 257	2   8   9 
 259	2   8   9 
 261	2   4   9 
 263	2   4   9 
 265	2   5   9 
 267	2   5   9 
 269	2   5  13 
 271	2   4  12 
 273	2  12   4 
 275	2   4  12 
 277	2  13   5 
 279	2   5  13 
 281	6   9   1 
 257	6  11   7 
 263	6   7   3 
 287	2   8  10 
 289	2  10   8 
 287	2   2   1 
 289	2   2   1 
 291	2   9   1 
 293	2   9   1 
 295	2   1   3 
 295	2   9  14 
 297	2   2   0 
 299	2   8  10 
 301	2  14   9 
 303	2   9  14 
 299	2   3   1 
 301	2   1   3 
 303	2   0   2 
 305	2   2   0 
