   1	2   4   5 
   3	2   4   5 
   5	2   4   1 
   7	2   4   1 
   9	2   5   1 
  11	2   5   1 
  13	2   4   9 
  15	2   4   9 
  17	2   5   9 
  19	2   5   9 
  13	6   7   2 
  21	2   1   9 
  23	2   1   9 
  25	2   4   6 
  27	2   4   6 
  29	2   5   6 
  31	2   5   6 
  33	2   4   0 
  35	2   4   0 
  37	2   1   6 
  37	2   4   8 
  39	2   1   6 
  39	2   4   8 
  41	2   9   6 
  43	2   9   6 
  45	6   9   4 
  45	6   6   2 
  51	2   5   0 
  53	2   5   0 
  51	6  11   7 
  55	2   1   0 
  57	2   1   0 
  59	2   4   0 
  55	2   9  12 
  57	2   9  12 
  59	2   9   6 
  61	2   5   8 
  63	2   5   8 
  65	2   4   0 
  67	2   2   0 
  67	6  11   9 
  69	2   2   0 
  73	2  11   6 
  75	2  11  10 
  77	2  11  10 
  73	6   8   0 
  79	2   1   0 
  81	2   1   0 
  79	2  11   9 
  81	2  11   9 
  83	2   4   0 
  85	2   4   0 
  87	2   2   0 
  89	2   2   0 
  83	6  12   9 
  91	6  10   2 
  97	2   5   9 
  99	2   5   9 
  97	2  11   3 
  99	2  11   3 
 101	2   8   0 
 103	2   8   0 
 105	2   5   6 
 107	2   5   6 
 109	2   5   2 
 111	2   5   2 
 113	2   1   9 
 109	2  11   7 
 115	2   1   9 
 117	2   4   9 
 119	2   4   9 
 121	2   1   6 
 123	2   1   6 
 125	2  10   9 
 127	2  10   9 
 125	2   1   2 
 129	2   8   9 
 131	2   8   9 
 127	2   1   2 
 129	2  11   7 
 133	6   9   1 
 131	6  15  11 
 139	2   4   6 
 141	2   4   6 
 143	2   0   1 
 145	2   0   1 
 139	2  15  13 
 141	2  15  13 
 143	2  10   6 
 145	2  10   6 
 147	2  15  14 
 149	2  15  14 
 151	2  15  11 
 153	2  15  11 
 147	6   8   5 
 153	2   5   6 
 153	2   8  12 
 155	6   3   1 
 155	2   8  12 
 157	2   9  12 
 159	2   9  12 
 161	2   5   6 
 163	6   4   1 
 161	6  13  12 
 169	2   1   2 
 171	2   1   2 
 169	2   8   4 
 171	2   8   4 
 163	6  10   7 
 169	6  13  10 
 175	6  13   8 
 175	2   7   2 
 177	2   7   2 
 181	2  13   8 
 183	2  13   8 
 179	6   6   1 
 185	2   9   4 
 187	6   7   5 
 187	2  13  12 
 193	2   9   4 
 195	2   0   1 
 195	2   9   8 
 197	2   0   1 
 197	2   6  10 
 199	2   6  10 
 197	2  13  12 
 201	6   6   4 
 207	2   3   1 
 207	2   9   8 
 209	2   3   1 
 209	2   9  12 
 207	6  15  11 
 213	2   4   6 
 215	2   4   6 
 213	2  13  14 
 215	2  13  14 
 217	2   5  10 
 219	2   5  10 
 221	6  14  13 
 221	2   7   2 
 223	2   5   6 
 225	2   7   2 
 227	2   7  10 
 225	2   4   8 
 229	2  14  15 
 227	2   4   8 
 229	2   5   6 
 231	6   8   4 
 231	2  14  15 
 233	2   7  10 
 237	2   9  12 
 237	2   0   2 
 239	6   5   0 
 239	2   8  12 
 245	2   5   2 
 241	2   8  12 
 235	6  15  11 
 241	6  14  11 
 247	2   3   2 
 247	2   5  10 
 243	6  12   8 
 249	2   9  13 
 249	2   3   2 
 251	2   7   6 
 249	2   0   4 
 251	2   0   4 
 253	2   1   2 
 251	2   9  13 
 253	2   9  14 
 255	2  12  13 
 255	2   5  10 
 257	2   1   2 
 257	2  12  13 
 259	2   7   6 
 259	2   0   8 
 261	2   0   8 
 263	6   8   0 
 261	6  10   7 
 267	2   3   7 
 269	2   3   7 
 269	2   9  14 
 271	2   8  13 
 273	2   8  13 
 271	2   5   6 
 273	2   5   6 
 275	2   3   6 
 275	2  12  14 
 277	6   3   1 
 277	2  12  14 
 279	6  10   8 
 285	2   8   4 
 285	2   3   7 
 285	2  10  14 
 287	2  10  14 
 289	2   1   6 
 287	2   8   4 
 291	2   3   7 
 291	2   5   4 
 289	6  14  12 
 293	2   5   4 
 295	2   1   4 
 297	6   4   1 
 303	2   4   1 
 305	2   2   7 
 307	2   2   7 
 305	2   8   0 
 309	2   3   6 
 307	2   8   0 
 311	2   3   6 
 313	2   5   0 
 309	6  12   8 
 315	2   5   0 
 315	2  12  13 
 317	2  12  13 
 319	2   5  13 
 321	2   5  13 
 323	2   2   6 
 323	2   4   0 
 325	6   3   1 
 331	2   2   6 
 331	2   4   0 
 333	2   1   3 
 335	2   7   6 
 337	2   1   3 
 339	2   1   0 
 339	2   7   6 
 341	2   1   0 
 333	2  12   8 
 335	2  12   8 
 337	6  13  12 
 343	2   4  12 
 343	2   2   3 
 345	2   2   3 
 345	2   4  12 
 347	2   2   0 
 349	2   7   3 
 351	2   7   3 
 349	2   5   8 
 351	2   5   8 
 353	2   6   3 
 355	2   6   3 
 353	2   4   8 
 357	2   2   0 
 357	6  12   9 
 359	6   2   0 
 365	6   8   0 
 365	2   7   2 
 371	2   1   9 
 373	2   7   2 
 373	2   4   0 
 375	2   1   9 
 377	2   1   0 
 379	2   1   0 
 377	2   8   9 
 379	2   8   9 
 375	6  11   7 
 381	2  11   9 
 383	2   1   4 
 385	2   6   2 
 385	2   8   0 
 387	2   6   2 
 389	2   3   2 
 387	2   8   0 
 389	2  11   9 
 391	6   1   0 
 397	2   4   0 
 399	2   0   4 
 391	2   6   9 
 397	2   3   2 
 401	2   8   5 
 393	6  11  10 
 399	6  11   3 
 403	2   5   8 
 405	2   6   9 
 407	2  11   9 
 409	2  11   9 
 407	6   2   1 
 413	6   6   2 
 419	2   8   5 
 421	2   1   9 
 423	2   1   9 
 419	6  15   7 
 425	6  12   8 
 425	2  10   6 
 427	2  10   6 
 429	2   2   6 
 431	2   2   6 
 429	6  15  14 
 435	2  11   6 
 437	2  11   6 
 431	6   8   0 
 439	2  11  15 
 439	2   1   6 
 441	2   1   6 
 443	2   9   6 
 445	2   9   6 
 443	2   1   0 
 441	2  15  11 
 443	2  11  15 
 447	2   6   7 
 447	2   9  14 
 449	2   2   3 
 449	2  10  13 
 451	2   3   2 
 453	2   2   3 
 451	2  13  10 
 453	2  10  13 
 455	2   0   1 
 457	2   1   0 
 455	2  14   9 
 457	2   9  14 
 455	2   7   6 
 457	2   6   7 
