   1	2   0   6 
   3	6   3   1 
   1	6   8   5 
   9	2   3   6 
  11	2   8   6 
  13	2   4   6 
  15	2   7   6 
