   1	2   2   1 
   3	2   5   1 
   5	6   3   1 
  11	2   7   3 
  11	6   1   0 
  13	2  11   3 
  15	2   6   3 
   5	6   9   8 
  17	2   1   3 
  17	6  10   9 
  19	6   7   3 
  19	6   1   0 
  25	2  10   7 
  25	6   2   1 
  27	6  14  11 
  27	6   9   8 
  33	2   2   7 
  33	6  10   9 
  39	2  11   7 
  39	6  13   5 
  45	2  15   7 
  47	2  10   7 
  49	2   5   7 
