   1	2   2   0 
   1	6   8   7 
   3	2   1   0 
   5	6   3   0 
   7	6   8   5 
  11	2   6   3 
  13	2   7   3 
  15	2   5   3 
  17	2   4   3 
  19	6   5   3 
  25	2   8   5 
  25	6   1   0 
  31	2   1   5 
