   1	6   5   0 
   1	6  15   7 
   7	2   5   6 
   9	2   1   6 
  11	2   7   6 
   1	6  12   8 
   9	6   9   8 
  15	2   9   6 
  17	2  10   6 
  19	2  11   6 
  11	6   1   0 
  21	2   1   6 
  19	6   9   8 
  25	2   9   6 
  21	6  15  11 
  27	2  14   6 
  29	2   4   6 
  31	2   3   6 
  33	2  11   6 
  35	2   2   6 
