   1	2   2   0 
   3	2   1   0 
   5	2   6   0 
   7	6   4   0 
  13	2   8   4 
  15	2   7   4 
  17	2   0   4 
  19	2   5   4 
  21	2   3   4 
