   1	2   0   3 
   3	2   6   3 
   5	2   4   3 
   7	2   5   3 
   9	2   1   3 
  11	6   2   0 
  17	2   0   3 
   9	6   8   7 
  19	2   7   3 
