   1	6   5   1 
   1	6  15  13 
   7	2  10   5 
   9	2   0   5 
  11	6  15  10 
  17	2  13   5 
  19	2  10   5 
   1	6   7   3 
  21	2   2   5 
  23	2   9   5 
  25	2   7   5 
  27	2   4   5 
  29	2   8   5 
  31	6  12   4 
  37	2   4   5 
  27	6  14  10 
  27	6   3   2 
  33	6  11   7 
  39	2  10   5 
  41	2   2   5 
  43	2   7   5 
  45	2   1   5 
  47	2   6   5 
