   1	6  15   7 
   7	2   6   7 
   9	6   7   6 
   1	6  13   9 
  15	2   9   6 
  17	2   2   6 
   7	6  15  14 
  19	2  14   6 
  21	2   5   6 
  23	2   4   6 
  25	2   1   6 
  27	2  10   6 
  27	6   1   0 
  33	2   1   6 
  35	2   3   6 
