   1	2   4   5 
   3	2   1   5 
   5	2   2   5 
   3	6   7   6 
   9	2   7   5 
  11	2   8   5 
  13	2   3   5 
