   1	6   5   3 
   7	2   5   8 
   9	2   5   8 
  11	2   5   2 
  11	6   7   6 
  13	2   5   2 
  15	2   5   1 
  17	2   8   2 
  19	2   8   2 
  21	2   5   1 
  23	2   5   3 
  25	2   5   3 
  27	2   5   4 
  29	2   5   4 
  31	2   5   7 
  33	2   5   7 
  35	6   5   1 
  35	6   6   3 
  41	2   8   5 
  41	2   1   0 
  43	2   8   5 
  43	2   1   0 
  45	2   2   5 
  45	6   3   0 
  47	2   2   5 
  49	6   8   7 
  51	6   2   0 
  55	2   7   6 
  57	2   7   6 
  59	2   0   6 
  61	2   7   4 
  63	2   0   6 
  65	2   7   4 
  67	2   0   4 
  69	2   7   8 
  69	6   2   0 
  71	2   7   8 
  73	6   7   6 
  79	2   5   7 
  81	2   5   7 
  83	2   2   4 
  85	2   5   4 
  87	2   2   8 
  87	2   6   3 
  89	2   5   4 
  91	2   2   8 
  91	2   6   3 
  93	2   7   4 
  95	2   5   8 
  95	6   3   1 
  97	2   5   8 
 101	2   2   1 
 103	2   7   4 
 105	2   2   1 
 105	2   7   8 
 107	2   5   1 
 109	2   7   8 
 111	2   5   1 
 113	2   4   8 
 115	2   7   1 
 117	2   4   8 
 119	2   7   1 
 121	2   4   1 
 123	2   4   1 
 125	2   4   2 
 127	2   7   5 
 129	2   5   7 
 131	2   2   4 
 133	2   4   2 
 135	2   7   5 
 137	6   5   1 
 143	2   8   5 
 145	2   8   5 
 147	2   5   3 
 149	2   8   6 
 151	2   6   8 
 153	2   3   5 
 155	2   5   3 
 157	2   8   6 
