   1	2   6   7 
   3	2   6   7 
   5	2   6   4 
   7	2   6   4 
   9	2   7   4 
  11	2   7   4 
  13	6   5   3 
  19	2   6   3 
  21	2   6   3 
  23	2   7   3 
  25	2   7   3 
  27	2   4   3 
  29	2   4   3 
  31	6   3   1 
  37	2   6   3 
  39	2   6   3 
  41	2   7   3 
  43	2   6   0 
  45	2   7   3 
  47	2   6   0 
  49	2   4   3 
  51	2   4   3 
  53	2   1   3 
  55	2   1   3 
  57	6   4   0 
  63	2   7   4 
  65	2   7   4 
  67	2   0   4 
  69	2   0   4 
  71	2   1   4 
  73	2   1   4 
  75	2   3   4 
  77	2   3   4 
  79	2   4   6 
  81	2   3   7 
  83	2   1   0 
  85	2   0   1 
  87	2   7   3 
  89	2   6   4 
  91	2   4   6 
  93	2   3   7 
  95	2   1   0 
