   1	2   4   1 
   3	2   4   1 
   5	2   4   7 
   7	2   4   7 
   9	2   1   7 
  11	2   4   5 
  13	2   1   7 
  15	2   4   5 
  17	2   1   5 
  19	2   4   2 
  21	2   1   5 
  23	2   4   2 
  25	2   7   5 
  27	2   1   2 
  29	2   7   5 
  31	2   1   2 
  33	6   4   2 
  39	2   7   4 
  41	2   7   4 
  43	2   5   4 
  45	2   5   4 
  47	2   4   2 
  49	2   5   1 
  51	2   1   5 
  53	2   2   4 
  55	2   4   2 
  57	2   5   1 
