   1	2   5   3 
   3	2   5   3 
   5	2   5   8 
   5	6   6   3 
   7	2   5   8 
  11	2   6   8 
  13	2   5   3 
  15	2   6   8 
  17	2   5   3 
  19	2   6   3 
  19	2   5   2 
  21	2   6   3 
  21	2   5   2 
  23	2   5   1 
  23	6   6   3 
  25	2   5   1 
  27	6   2   1 
  29	2   8   6 
  31	2   8   6 
  33	2   3   1 
  35	2   3   1 
  37	2   5   4 
  39	2   5   4 
  41	6   2   0 
  41	6   8   7 
  47	2   7   1 
  49	2   3   0 
  51	2   7   1 
  53	2   3   0 
  55	2   3   4 
  57	2   3   4 
  59	6   6   0 
  65	2   0   1 
  65	2   7   6 
  67	2   0   1 
  67	2   7   6 
  69	2   0   6 
  71	2   7   4 
  73	2   0   6 
  75	2   7   4 
  77	2   0   4 
  79	2   0   4 
  81	6   3   1 
  87	2   3   6 
  89	2   3   6 
  91	2   3   4 
  93	2   3   4 
  95	2   6   4 
  97	2   6   4 
  99	2   4   5 
 101	2   3   7 
 103	2   7   3 
 105	2   5   4 
 107	2   4   5 
 109	2   3   7 
 111	6   3   1 
 117	2   6   3 
 119	2   3   6 
 121	2   6   3 
