   1	6   5   3 
   7	2   6   7 
   9	2   6   7 
   7	6   1   0 
  13	2   6   4 
  15	2   6   4 
  17	2   7   4 
  19	2   7   4 
  21	2   6   3 
  23	2   6   3 
  25	2   7   3 
  27	2   7   3 
  29	2   4   3 
  31	2   4   3 
  33	2   6   0 
  35	2   6   0 
  37	6   6   0 
  43	2   7   6 
  45	2   7   6 
  43	2   0   1 
  47	2   4   6 
  49	2   4   6 
  51	2   3   6 
  53	2   3   6 
  55	2   0   1 
  57	2   7   1 
  59	2   7   1 
  61	2   4   1 
  63	2   4   1 
  65	2   3   1 
  67	2   3   1 
  69	2   3   4 
  71	2   4   3 
  73	2   3   4 
  75	6   3   1 
  81	2   6   3 
  83	2   6   3 
  85	2   3   0 
  87	2   6   7 
  89	2   7   6 
  91	2   6   7 
  93	2   0   3 
  95	2   3   0 
