   1	6   7   3 
   7	2   7   8 
   9	2   7   8 
   1	6   2   1 
  11	2   7   1 
  13	2   7   1 
  15	6   8   2 
  21	2   2   1 
  23	2   2   1 
  21	2   7   8 
  23	2   7   8 
  25	2   2   8 
  27	6   8   2 
  33	2   8   2 
  35	2   1   2 
  37	2   1   2 
  39	2   7   5 
  41	2   7   5 
  43	2   8   5 
  45	2   8   5 
  39	6   3   0 
  47	2   7   4 
  49	2   7   4 
  51	2   1   5 
  53	2   1   5 
  55	2   2   5 
  57	2   2   5 
  51	2   7   6 
  53	2   7   6 
  55	2   7   3 
  57	2   7   3 
  59	2   8   4 
  61	2   8   4 
  63	2   1   4 
  65	2   1   4 
  67	2   2   4 
  69	2   2   4 
  71	2   5   4 
  73	2   5   4 
  75	2   8   6 
  77	2   8   6 
  79	6   8   6 
  85	2   6   3 
  87	2   6   3 
  75	6   2   1 
  85	2   2   8 
  87	2   2   8 
  89	6   3   1 
  95	2   2   1 
  97	2   2   1 
  89	6   8   7 
  95	2   3   7 
  97	2   3   7 
  99	2   5   7 
 101	2   5   7 
 103	2   4   7 
 105	2   4   7 
 107	2   3   1 
 109	2   3   1 
 111	2   5   1 
 113	2   5   1 
 115	2   4   1 
 117	2   4   1 
 119	2   7   1 
 121	2   7   1 
 123	2   7   6 
 125	2   6   7 
 127	2   7   6 
 123	6   5   1 
 129	2   5   8 
 129	2   1   3 
 131	2   4   2 
 133	2   3   1 
 135	2   1   3 
 133	2   8   5 
 135	2   5   8 
 137	2   2   4 
 139	2   4   2 
