   1	2   6   4 
   3	2   6   7 
   5	2   4   6 
   7	2   7   4 
   9	2   7   6 
  11	2   4   6 
  13	2   7   4 
  15	2   0   3 
  17	2   6   7 
  19	2   6   0 
  21	2   3   6 
  23	2   3   0 
  25	2   6   0 
  27	2   3   6 
  29	2   6   7 
  31	2   4   6 
  33	2   7   4 
  35	2   7   6 
  37	2   4   6 
  39	2   7   4 
  41	2   0   3 
  43	2   0   3 
  45	2   6   7 
  47	2   6   0 
  49	2   3   6 
  51	2   3   0 
  53	2   6   0 
  55	2   3   6 
  57	2   4   6 
  59	2   0   3 
