   1	2   0   3 
   3	2   6   4 
   5	2   3   6 
   7	2   0   3 
   9	2   6   0 
  11	2   6   3 
  13	2   0   3 
  15	2   6   0 
  17	2   3   6 
  19	2   0   1 
  21	2   1   4 
  23	2   0   1 
  25	2   4   0 
  27	2   4   1 
  29	2   0   1 
  31	2   4   0 
  33	2   1   4 
