   1	2   5   9 
   1	6   3   2 
   3	2   9   8 
   5	2   8  13 
   5	6  11  10 
   7	6   2   0 
  11	6  14   9 
  13	6  11   7 
  17	2   8   0 
  19	2   5  10 
  21	2   5   9 
  21	2  14  11 
  23	2  10   9 
  25	2  10  11 
  25	6   5   2 
  27	6  14  11 
  31	2   9   5 
  31	6   3   2 
  33	2  13  14 
  35	2  14   9 
  37	6  10   2 
  33	6   4   0 
  39	6   8   4 
  43	2  13  10 
  43	6   3   2 
  45	2  10   5 
  47	2  10   8 
  49	2  14  10 
  49	2   5   8 
  51	2  10   5 
  53	2   5   2 
  53	6  14  12 
  55	2   2   3 
  57	6   3   1 
  59	2  10   8 
  61	2   9  13 
  63	2  12   4 
  63	6   6   2 
  65	2   9   4 
  67	6   8   0 
  69	6  11   3 
  73	2   1   0 
  75	2   1   3 
  77	2   5  13 
  79	2   6   4 
  81	6   2   0 
  79	6  15  13 
  85	6  15  11 
  87	2   2   3 
  89	6   9   1 
  91	6  11   7 
  95	6   5   4 
  97	2   7   3 
 101	2   6   7 
 103	2   6   5 
 105	2   6   1 
 107	2   7   2 
 109	2   9   1 
 109	2   7   3 
 111	2   9  10 
 111	2   1   2 
 113	2   9  12 
 113	6   3   1 
 115	6  10   9 
 119	6   2   0 
 121	6  12   8 
 125	2   1   5 
 125	2  10   7 
 127	2   1   4 
 127	6  11   3 
 129	2   5   8 
 131	2   9   4 
 133	2   6   1 
 133	2   9   8 
 135	2   4   0 
 135	2   6   9 
 137	2   1   0 
 137	6  10   8 
 143	2   1   4 
 143	2   6  10 
 145	2   5   9 
 145	6   7   2 
 151	2   5   0 
 153	2   9  11 
 155	2   5  10 
 157	2   8   0 
 159	2   6   1 
 161	2   8  10 
 161	2   1   0 
 163	2   6   9 
 165	2   6  10 
 165	6   4   1 
 167	6  11   3 
 171	6   8   5 
 177	2   2   1 
 179	2   2   3 
 181	2   1   3 
 183	2   4   1 
 185	2   6   4 
 187	6   3   1 
 187	6  10   9 
 193	2   5   1 
 193	6  10   7 
 195	6   8   0 
 201	2   5   2 
 203	2   5   0 
 205	2   1   3 
 205	6  10   8 
 207	2   1   0 
 211	2   0   2 
 211	6  11   9 
 217	2   7   3 
 217	2   5   1 
 219	2   7  11 
 219	6   9   4 
 225	2   2  10 
 227	2  10  11 
 227	6   3   1 
 233	2   9  11 
 235	2   6   2 
 237	2   9   1 
 239	2   2   1 
 239	6  10   7 
 241	6   1   0 
 245	2   6  10 
 247	2   2   7 
 247	6   8   0 
 249	2   3   7 
 251	6  11   7 
 253	6   2   1 
 259	2   5  10 
 259	2   3   2 
 261	2   5   7 
 263	2   7   2 
 265	2   6   9 
 267	2  10   8 
 269	2   6  10 
 271	6   7   2 
 271	6  10   9 
 277	2  11   7 
 279	2  10   7 
 281	2   6  11 
 283	6   6   3 
 277	6   8   0 
 289	2  10   6 
 291	2   5   6 
 293	2   5   1 
 293	6  10   7 
 299	2   5   2 
 301	2   6  10 
 303	2  10   9 
 303	2   1   2 
 305	2   9  11 
 305	2   1   0 
 307	2   3   7 
 307	6   1   0 
 309	6  11   3 
 315	2   3   1 
 315	2  11  10 
 317	2   2   1 
 317	6  11   9 
 319	6   2   0 
 325	2  11   3 
 327	2   7   5 
 329	2   9   6 
 331	6  10   2 
 337	2   3   2 
 337	2  11  10 
 337	6   5   0 
 339	6   3   2 
 345	2   2   5 
 347	2   5  10 
 347	6   7   3 
 349	2   5   0 
 353	2   3   1 
 355	2  11   6 
 357	2  10   6 
 359	6   3   1 
 365	2   7   3 
 365	6   1   0 
 371	2   3   1 
