   1	2   0   6 
   3	2   0   4 
   5	2   6   4 
   7	6   2   0 
   7	6   7   6 
  13	2   2   5 
  15	2   2   1 
  17	2   7   5 
  19	2   2   0 
  21	2   7   1 
  23	2   4   5 
  25	2   2   8 
  25	6   3   0 
  31	2   7   3 
  33	2   4   1 
  35	2   2   0 
  35	2   7   8 
  37	2   4   3 
  39	2   5   1 
  41	2   4   8 
  43	2   5   3 
  45	2   5   8 
  45	2   1   3 
  47	6   7   1 
  53	2   1   0 
  53	2   7   8 
  55	2   2   1 
  55	6   7   3 
  61	2   4   0 
  63	2   2   4 
  65	2   1   4 
  67	2   7   8 
  67	6   2   0 
  73	2   5   2 
  75	6   2   0 
  69	6   7   6 
  75	6   8   7 
  81	2   2   5 
  81	2   3   0 
  83	2   1   5 
  85	2   6   0 
  87	2   4   5 
  89	6   2   0 
  89	6   8   7 
  95	2   0   3 
  95	2   8   2 
  97	2   0   6 
  99	2   1   3 
  99	6   8   7 
 101	6   3   1 
 107	2   3   6 
 109	2   4   1 
 111	2   4   6 
 113	2   5   1 
 113	6   7   6 
 119	2   0   6 
 119	6   8   5 
 121	2   3   6 
 123	6   3   1 
 125	2   8   7 
 129	2   0   2 
 131	2   1   2 
 131	2   3   7 
 133	2   4   6 
 135	2   0   1 
 135	2   8   6 
 137	2   4   2 
 139	2   0   4 
 141	2   8   2 
 141	2   3   6 
 143	2   1   4 
 145	2   7   6 
 145	6   2   0 
 147	6   7   6 
 151	6   5   1 
 157	2   2   8 
 157	2   3   0 
 159	2   5   8 
 159	2   6   0 
 161	2   4   8 
 163	6   2   0 
 163	6   8   7 
 169	2   0   3 
 169	2   8   2 
 171	2   0   6 
 173	2   5   3 
 175	2   4   3 
 177	2   7   3 
 179	6   8   6 
 185	2   0   6 
 185	2   5   8 
 187	2   0   2 
 187	6   8   7 
 193	2   4   7 
 195	2   8   7 
 197	2   3   7 
 199	6   5   3 
 205	2   3   6 
 205	6   2   1 
 207	6   8   6 
 213	2   3   1 
 215	2   4   8 
 217	2   4   1 
 219	2   6   8 
 221	2   5   8 
 221	6   3   1 
 223	2   7   8 
 227	2   6   3 
 229	2   5   3 
 231	2   7   3 
 233	6   5   3 
 239	2   8   5 
