   1	2   4   1 
   3	2   4   2 
   5	2   4   6 
   7	2   1   2 
   7	6   7   6 
   9	6   5   1 
  15	2   4   8 
  17	2   5   7 
  19	2   4   3 
  21	2   5   8 
  23	2   4   1 
  25	2   5   3 
  27	2   5   1 
  29	2   4   5 
  31	6   4   2 
  37	2   4   7 
  39	2   4   8 
  41	2   4   3 
  43	2   7   8 
  45	2   4   1 
  47	2   7   3 
  49	2   2   4 
  51	2   7   1 
  53	2   5   4 
  55	6   5   3 
  61	2   8   5 
  63	6   7   1 
  69	2   2   1 
  69	2   8   7 
  71	2   2   8 
  73	2   3   1 
  73	6   8   7 
  79	2   5   8 
  81	2   2   5 
  81	2   3   7 
  83	2   4   1 
  85	2   2   8 
  87	2   3   5 
  89	2   4   7 
  91	2   4   5 
  93	2   1   7 
  95	2   1   5 
  97	2   7   5 
  99	6   5   3 
 105	2   5   8 
 107	2   2   5 
 109	2   4   8 
 111	2   2   4 
 113	2   5   4 
 115	6   5   1 
 115	6   6   3 
 121	2   5   8 
 123	2   2   5 
 125	2   7   8 
 125	6   2   1 
 127	2   6   8 
 129	6   6   3 
 131	2   2   5 
 133	6   8   2 
 139	2   1   7 
 141	2   1   3 
 141	2   8   7 
 143	2   4   5 
 145	2   1   2 
 145	6   8   6 
 147	6   2   1 
 151	2   6   3 
 153	2   4   7 
 155	2   4   3 
 157	2   5   7 
 159	2   5   3 
 161	2   7   3 
 163	6   3   1 
 169	2   6   3 
 171	2   4   3 
 173	2   5   3 
 175	2   7   3 
 177	2   1   3 
