   1	6   8   6 
   1	2   2   1 
   7	2   2   8 
   9	6   8   2 
  15	2   8   6 
  17	2   8   7 
  15	2   1   2 
  17	6   1   0 
  23	2   8   4 
  25	2   8   5 
  25	2   0   6 
  27	6   8   2 
  27	6   3   0 
  33	2   2   0 
  35	2   2   1 
  35	2   3   7 
  37	2   3   4 
  39	2   3   5 
  41	2   8   6 
  43	2   3   0 
  43	2   8   7 
  45	2   8   4 
  47	6   3   0 
  47	2   8   5 
  49	6   8   5 
  53	2   0   1 
  55	2   5   3 
  57	6   5   1 
  57	2   6   7 
  63	2   6   4 
  65	2   7   4 
  67	2   2   0 
  69	2   6   8 
  71	2   1   5 
  73	2   2   1 
  71	2   6   3 
  75	2   0   1 
  73	2   7   8 
  75	6   8   6 
  81	2   8   5 
  77	6   1   0 
  83	2   2   8 
  85	2   7   3 
  87	2   4   6 
  89	2   7   5 
  91	2   4   3 
  93	2   4   5 
  95	6   7   1 
 101	2   6   3 
 101	2   2   1 
 103	2   2   4 
 105	6   8   6 
 111	2   8   5 
 111	6   3   1 
 117	2   2   8 
 119	2   1   5 
 121	2   2   1 
 123	2   2   5 
 119	2   7   6 
 121	2   7   3 
 125	2   7   4 
 127	2   7   8 
 129	2   7   1 
 131	2   7   5 
 133	2   0   6 
 135	2   0   3 
 137	2   6   3 
 133	6   5   2 
 139	2   0   4 
 141	2   6   4 
 143	6   8   7 
 143	6   1   0 
 149	2   1   7 
 151	2   5   8 
 153	2   6   7 
 151	2   1   0 
 153	2   1   2 
 155	2   3   4 
 157	2   6   0 
 159	2   3   7 
 157	6   5   2 
 161	2   3   0 
 163	2   2   1 
 165	2   4   7 
 167	6   8   6 
 173	2   8   5 
 167	6   1   0 
 173	2   6   0 
 175	2   3   5 
 177	2   4   1 
 179	2   4   5 
 181	2   7   1 
 183	2   2   8 
 183	6   3   0 
 185	2   7   5 
 189	2   2   0 
 187	6   8   7 
 193	2   2   4 
 195	2   6   7 
 195	2   1   5 
 197	2   2   8 
 199	2   2   1 
 201	2   2   5 
 199	2   3   7 
 201	2   6   0 
 203	2   3   0 
 205	2   6   4 
 207	2   6   8 
 209	6   8   5 
 207	6   1   0 
 213	2   6   0 
 215	2   6   8 
 217	2   3   4 
 219	2   3   5 
 221	2   7   1 
 223	2   7   4 
 225	2   1   4 
 227	2   3   0 
 227	2   7   5 
 229	2   1   5 
 231	2   4   5 
 233	6   8   6 
 233	6   1   0 
 239	2   3   6 
 241	2   7   1 
 243	2   7   6 
 243	2   0   1 
 245	2   0   6 
 247	2   4   1 
 249	2   4   6 
 251	2   5   1 
 251	6   7   6 
 257	2   5   7 
 259	2   1   7 
