   1	6  13  10 
   7	2   6  10 
   9	2   6   2 
  11	2   6   7 
  13	2   6   5 
  15	2  10   2 
  17	2  10   7 
  19	2   2   7 
  21	2   6   4 
  23	2  10   5 
  25	2   6   1 
  25	6  13   9 
  27	6   2   0 
  31	6  10   9 
  33	6   7   2 
  39	2   0   5 
  37	6  15  14 
  43	2   6  10 
  45	2   2   5 
  47	6  10   8 
  53	2   6   7 
  53	2   9   4 
  55	2   9   1 
  57	2   6   3 
  57	2   9   8 
  59	2   0   4 
  61	2   0   1 
  63	2   6  14 
  63	2   0   8 
  65	6  11   9 
  65	6   2   0 
  71	2  11   7 
  73	2   2   7 
  71	2   0   4 
  75	2  11   3 
  75	2   0   1 
  77	6   7   2 
  77	2   0   8 
  83	2  11  14 
  79	2   5   4 
  83	2   0   2 
  85	2   7   3 
  87	2   6  11 
  89	6   2   0 
  95	2   5   1 
  97	2   4   1 
  89	6  14  10 
  99	2   2   3 
  99	2   5   8 
 101	6   5   1 
 101	2   7  10 
 107	6   6   3 
 113	2   2  10 
 107	2   4   8 
 115	2   3   7 
 115	2   1   0 
 117	2   3   2 
 117	2   4   0 
 115	6  10   9 
 121	2   1   6 
 123	2  11   7 
 123	2   1   9 
 125	2   5   8 
 127	2   5   0 
 129	6   3   1 
 135	2   1   3 
 137	2   8   0 
 139	2   4   6 
 141	2   4   9 
 143	6   6   4 
 149	2   5   4 
 151	2   5   9 
 149	6   7   2 
 153	2   8   4 
 155	2   0   4 
 157	2   8   9 
 155	2  11   7 
 157	2   1   6 
 159	2   2   7 
 161	2   1   5 
 161	2  11   3 
 163	6  10   5 
 163	2   2   3 
 169	2  11   6 
 171	2   2   6 
 173	2  11  10 
 175	6  11   3 
 181	2   7  11 
 183	2   7   6 
 169	6   8   4 
 175	2   1   4 
 177	6   4   1 
 185	2   2  10 
 187	2   3   1 
 189	6   3   1 
 195	2   2   3 
 187	6   9   8 
 197	2  11   6 
 195	2   0   8 
 197	2   4   0 
 199	6   2   0 
 205	2   1   2 
 207	2   0   2 
 209	2   7  10 
 211	2  11  10 
 213	2   6  10 
 215	6  11   3 
 221	2   7  11 
 215	2   9   8 
 217	2   4   9 
 221	2   1   9 
 223	2   4   8 
 223	2   7   2 
 225	2   3  11 
 227	2   3   2 
 229	2   6  11 
 231	2  10  11 
 233	6  11   7 
 225	6   8   4 
 231	2   1   4 
 239	2   6   2 
 233	6   8   0 
 241	2   0   1 
 239	2   8   9 
 241	2  11   9 
 243	6  11   9 
 249	2   8   4 
 251	2   0   8 
 253	2   9   4 
 249	2   3  11 
 255	2   6  11 
 257	2  10   2 
 259	2  10  11 
 255	6   8   4 
 259	6   3   2 
 261	6  10   8 
 267	6   5   0 
 267	2   7   3 
 273	2   5   9 
 269	2   7  11 
 275	2   1   4 
 277	2   1   9 
 279	2   4   9 
 281	2   2  10 
 283	2   6  10 
 285	2   8  10 
 287	2   7  10 
 285	6   2   1 
 291	2   5   1 
 293	2   2   1 
 289	6  10   7 
 295	2   5   6 
 297	2   2   6 
 299	2   5   8 
 299	2   3  11 
 301	6   6   5 
 307	2   6  10 
 307	2   4   1 
 309	2   4   5 
 311	2   9   1 
 309	2   3   7 
 311	2  11   7 
 313	2   6   3 
 315	2   6  11 
 317	2   6   7 
 313	6   8   0 
 319	2   2   0 
 321	2   2  10 
 321	2   4   0 
 323	6   6   4 
 329	6   4   0 
 329	2   2   3 
 331	2   6  10 
 333	2   6   3 
 335	6  11   3 
 335	2   9   5 
 337	2   9   4 
 339	2   1   5 
 341	2   2   3 
 343	2   2   7 
 345	2   6   3 
 347	2   9  10 
 349	2   6   7 
 347	2   1   4 
 351	2   9  11 
 353	2   5   4 
 355	6  11   9 
 361	2  11   3 
 363	6  10   5 
 363	6   3   2 
 369	2  11   7 
 369	2   1   5 
 371	2   1   9 
 373	2  10   5 
 375	2   4   5 
 377	2   1   2 
 377	2  10   9 
 379	2   4   9 
 379	6   7   6 
 385	2   1   6 
 387	2  10   2 
 389	2   5   9 
 391	2  10   6 
 391	6   4   1 
 397	2   1   2 
 393	6  10   9 
 399	2   1   6 
 401	2   5   2 
 403	2   5   6 
 405	2  10   2 
 407	2  10   6 
 409	2   2   6 
