   1	2   4   1 
   3	2   4   2 
   5	2   4   6 
   7	2   4   8 
   9	2   1   2 
   9	6   7   6 
  15	2   4   3 
  17	6   4   2 
  23	2   1   7 
  25	2   4   7 
  27	6   5   1 
  33	2   5   8 
  35	2   2   1 
  35	6   8   6 
  41	2   5   3 
  43	2   4   6 
  45	2   7   6 
  47	2   4   3 
  49	6   8   2 
  55	2   7   3 
  57	2   6   3 
  57	2   5   1 
  59	2   8   5 
  59	6   3   1 
  65	2   4   3 
  67	2   8   4 
  69	2   5   4 
  71	2   7   3 
  73	6   7   5 
  79	2   8   5 
  79	2   6   3 
  81	2   7   5 
  83	2   8   6 
  85	2   4   5 
  87	2   1   3 
  87	6   8   5 
  93	2   5   1 
  93	2   7   6 
  95	2   7   1 
  97	2   5   3 
  99	2   4   6 
 101	2   4   1 
 103	2   7   3 
 105	2   4   3 
 107	2   5   7 
 109	2   5   4 
 111	2   7   4 
 113	2   8   6 
 115	6   8   5 
 115	6   6   0 
 121	2   5   1 
 123	2   0   1 
 125	2   5   3 
 127	2   8   5 
 127	2   0   3 
 129	2   1   3 
 131	6   8   2 
 137	2   2   0 
 139	2   7   5 
 139	6   3   0 
 145	2   2   1 
 145	2   7   3 
 147	2   7   1 
 149	2   4   5 
 151	2   4   3 
 153	2   5   3 
 155	2   2   0 
 155	6   7   6 
 161	2   6   0 
 157	6   5   2 
 163	2   4   1 
 165	2   4   0 
 167	2   2   1 
 169	2   2   0 
 171	2   3   1 
 173	2   3   0 
 175	2   1   0 
