   1	2   0   6 
   3	2   0   4 
   5	2   6   4 
   7	6   2   0 
  13	2   2   5 
   7	6   7   6 
  15	6   5   3 
  21	2   2   1 
  21	2   7   3 
  23	2   2   0 
  25	2   7   1 
  27	2   2   8 
  29	2   2   5 
  31	2   4   3 
  33	2   4   1 
  35	6   3   0 
  41	2   7   3 
  43	2   4   3 
  45	2   7   8 
  47	2   7   5 
  45	2   0   1 
  47	2   0   3 
  49	2   4   8 
  51	2   4   5 
  53	2   1   3 
  53	6   8   7 
  59	2   2   8 
  55	6   3   0 
  61	2   3   7 
  63	2   1   7 
  65	2   2   4 
  67	2   8   4 
  69	2   3   5 
  71	2   1   5 
  73	6   2   0 
  79	2   0   3 
  73	6   8   7 
  79	2   2   8 
  81	2   2   5 
  83	2   0   1 
  85	2   0   2 
  87	2   8   5 
  87	6   6   0 
  93	2   7   3 
  89	6   5   2 
  95	2   6   8 
  97	2   7   1 
  99	2   7   5 
 101	2   4   3 
 103	2   4   1 
 105	2   7   8 
 105	2   3   1 
 107	2   4   5 
 109	2   3   5 
 111	2   4   8 
 113	6   6   0 
 119	2   0   2 
 121	6   7   3 
 127	2   7   8 
 121	6   2   1 
 127	2   3   1 
 129	2   4   1 
 131	2   7   1 
 133	2   2   5 
 133	2   0   3 
 135	2   0   4 
 137	2   3   4 
 139	2   2   8 
 141	2   2   1 
 143	6   2   1 
 141	6   7   3 
 149	2   0   3 
 151	2   0   1 
 149	2   5   8 
 153	2   7   3 
 153	2   5   2 
 155	2   7   1 
 157	6   4   0 
 163	2   0   3 
 163	2   8   2 
 165	2   4   5 
 167	2   4   8 
 169	2   4   2 
 171	2   7   5 
 173	2   7   8 
 171	2   0   1 
 173	2   3   1 
 175	6   2   0 
 181	2   2   5 
 175	6   7   6 
 181	2   6   0 
 183	2   2   8 
 185	2   2   0 
 185	6   8   7 
 191	2   3   5 
 193	2   3   7 
 195	2   3   0 
 197	2   1   5 
 199	2   1   7 
 201	2   1   0 
 201	2   5   7 
 203	6   1   0 
 209	2   5   1 
 211	2   7   1 
