   1	2   4   1 
   3	2   3   6 
   3	2   5   2 
   5	2   4   1 
   7	2   3   6 
   7	2   5   2 
   9	2   4   1 
  11	2   3   6 
  11	2   5   2 
  13	2   4   3 
  15	2   1   2 
  15	2   8   6 
  17	2   4   3 
  19	2   1   2 
  19	2   8   6 
  21	2   4   3 
  23	2   1   2 
  23	2   8   6 
  25	2   4   8 
  27	2   2   5 
  29	2   3   1 
  31	2   4   8 
  33	2   2   5 
  35	2   3   1 
  37	2   4   8 
  39	2   2   5 
  41	2   3   1 
  43	2   1   4 
  45	2   8   6 
  47	2   5   3 
  49	2   1   4 
  51	2   8   6 
  53	2   5   3 
  55	2   1   4 
  57	2   8   6 
  57	6   2   1 
  59	2   6   8 
  61	2   6   8 
  63	2   5   3 
  65	2   2   5 
  65	6   3   0 
  67	2   2   5 
  69	2   2   5 
  71	2   0   1 
  71	2   6   8 
  73	2   0   1 
  73	2   6   8 
  75	2   0   1 
  75	2   6   8 
  77	2   0   2 
  79	2   5   1 
  81	2   0   2 
  83	2   5   1 
  85	2   6   8 
  87	2   0   2 
  89	2   5   1 
  91	2   1   5 
  93	2   8   6 
  95	2   0   2 
  97	2   1   5 
  99	2   8   6 
 101	2   0   2 
 103	2   1   5 
 105	2   8   6 
 107	2   0   2 
