   1	2   2   1 
   3	2   7   5 
   5	2   2   1 
   7	2   7   5 
   9	2   2   1 
  11	2   7   5 
  13	2   7   1 
  15	2   4   2 
  17	2   7   1 
  19	2   4   2 
  21	2   7   1 
  23	2   4   2 
  25	2   4   1 
  27	2   4   1 
  29	2   4   1 
  31	6   4   2 
  37	2   7   4 
  39	2   7   4 
  41	2   7   4 
  43	2   4   5 
  45	2   7   1 
  47	2   4   5 
  49	2   7   1 
  51	2   4   5 
  53	2   7   1 
  55	2   5   7 
  57	2   2   1 
  59	2   5   7 
  61	2   2   1 
  63	2   5   7 
  65	2   2   1 
