   1	2   5   4 
   3	2   5   4 
   5	2   5   4 
   7	6   3   1 
  13	2   3   6 
  13	2   1   2 
  15	2   3   6 
  15	2   1   2 
  17	2   3   6 
  17	2   1   2 
  19	2   4   6 
  21	2   4   6 
  23	2   4   6 
  25	2   8   6 
  25	6   2   1 
  27	2   8   6 
  29	2   8   6 
  31	2   1   3 
  33	2   1   3 
  35	2   1   3 
  37	6   4   0 
  43	2   7   4 
  45	2   7   4 
  47	2   7   4 
  49	2   5   7 
  49	6   1   0 
  51	2   5   7 
  53	2   5   7 
  55	2   4   2 
  57	2   4   2 
  59	2   4   2 
  61	2   7   3 
  61	6   5   2 
  63	2   7   3 
  65	2   7   3 
  67	2   2   1 
  67	2   6   3 
  69	2   5   4 
  71	2   2   1 
  71	2   8   7 
  73	2   5   4 
  75	2   2   1 
  75	2   6   3 
  77	2   5   4 
  79	2   0   2 
  79	2   8   7 
  81	2   5   4 
  83	2   0   2 
  83	2   8   7 
  85	2   5   4 
  87	2   0   2 
  87	2   7   8 
  89	2   6   3 
  91	2   5   4 
  93	2   6   4 
  95	2   1   3 
  95	2   7   8 
  97	2   5   2 
  97	6   6   0 
  99	2   5   2 
 101	2   5   2 
 103	2   0   4 
 105	2   1   3 
 105	2   7   8 
 107	2   0   4 
 109	2   1   3 
 111	2   6   8 
 111	2   2   1 
 113	2   0   3 
 113	2   5   7 
 115	2   6   8 
 115	2   2   1 
 117	2   0   3 
 117	2   5   7 
 119	2   6   8 
 119	2   2   1 
 121	2   0   3 
 121	2   5   7 
 123	2   0   4 
 125	2   8   6 
 127	2   7   3 
 127	2   5   2 
 129	2   0   4 
 131	2   8   6 
 133	2   7   3 
 133	2   5   2 
 135	2   0   4 
 137	2   8   6 
 139	2   7   3 
 139	2   5   2 
 141	2   8   7 
 141	2   2   0 
 143	2   5   3 
 145	2   4   6 
 147	2   8   7 
 147	2   2   0 
 149	2   5   3 
 151	2   4   6 
 153	2   8   7 
 153	2   2   0 
 155	2   5   3 
 157	2   4   6 
 159	2   6   0 
 159	6   8   5 
 161	2   6   0 
 163	2   6   0 
 165	2   5   3 
 167	2   7   8 
 169	2   2   4 
 171	2   5   3 
 173	2   7   8 
 175	2   2   4 
 177	2   5   3 
 179	2   7   8 
 181	2   2   4 
