   1	2   6   4 
   3	2   6   4 
   5	2   6   4 
   7	6   5   2 
  13	2   2   0 
  15	2   2   0 
  17	2   2   0 
   7	6   7   6 
  19	2   8   5 
  21	2   8   5 
  23	2   8   5 
  19	2   3   1 
  21	2   3   1 
  23	2   3   1 
  25	2   4   3 
  27	2   4   3 
  29	2   4   3 
  31	2   5   7 
  33	2   5   7 
  31	2   0   1 
  33	2   0   1 
  35	2   0   1 
  35	2   5   7 
  37	2   1   5 
  39	2   1   5 
  41	2   1   5 
  37	6   7   6 
  43	6   3   1 
  49	2   6   0 
  51	2   6   0 
  53	2   6   0 
  43	6   8   5 
  49	2   5   2 
  51	2   5   2 
  53	2   5   2 
  55	2   1   5 
  57	2   2   4 
  59	2   2   4 
  61	2   2   4 
  63	2   2   4 
  65	2   2   4 
  67	2   2   4 
  69	2   3   6 
  71	2   3   6 
  73	2   3   6 
  69	2   1   5 
  75	2   4   6 
  77	6   4   3 
  83	2   2   4 
  85	2   3   6 
  85	2   1   5 
  87	2   1   0 
  89	2   1   0 
  87	2   5   8 
  89	2   5   8 
  91	2   5   8 
  91	2   1   0 
  93	2   3   6 
  95	2   6   3 
  97	2   6   3 
  93	6   5   1 
  99	2   6   3 
 101	2   0   1 
 103	2   0   1 
 105	2   0   1 
  99	2   8   5 
 101	2   8   5 
 103	2   8   5 
 107	2   2   4 
 109	2   2   4 
 111	2   5   4 
 113	2   5   4 
 115	2   5   4 
 117	2   6   4 
 119	2   6   4 
 121	2   6   4 
 123	6   8   6 
 123	6   1   0 
 129	2   2   1 
 131	2   2   1 
 133	2   2   1 
 135	2   2   5 
 137	2   2   5 
 139	2   2   5 
 135	2   0   6 
 137	2   0   6 
 139	2   0   6 
 141	2   1   0 
 143	2   1   0 
 145	2   1   0 
 147	2   1   2 
 149	2   1   2 
 151	2   1   2 
 147	2   3   6 
 149	2   3   6 
 151	2   3   6 
 153	2   6   3 
 155	2   6   3 
 157	2   6   3 
 153	2   5   8 
 155	2   5   8 
 157	2   5   8 
 159	2   0   4 
 161	2   0   4 
 163	2   0   4 
