   1	2   4   1 
   3	2   4   1 
   5	2   4   1 
   7	2   3   6 
   9	2   3   6 
   7	2   5   2 
  11	2   3   6 
   9	2   5   2 
  11	2   5   2 
  13	2   8   6 
  15	2   8   6 
  17	2   8   6 
  19	2   4   3 
  21	2   4   3 
  23	2   4   3 
  25	2   4   8 
  27	2   4   8 
  29	2   4   8 
  31	2   1   2 
  33	2   1   2 
  31	2   8   6 
  35	2   1   2 
  33	2   8   6 
  35	2   8   6 
  37	2   2   5 
  39	2   2   5 
  41	2   2   5 
  43	2   6   8 
  45	2   6   8 
  47	2   3   1 
  49	2   6   8 
  51	2   3   1 
  53	2   3   1 
  55	2   6   8 
  57	2   5   3 
  59	2   5   3 
  61	2   6   8 
  63	2   5   3 
  65	2   1   4 
  67	2   1   4 
  69	2   1   4 
  71	2   6   8 
  73	2   8   6 
  75	2   8   6 
  71	6   2   1 
  77	2   2   5 
  79	2   2   5 
  81	2   2   5 
  77	6   3   0 
  83	2   8   6 
  83	2   0   1 
  85	2   0   1 
  87	2   0   1 
  89	2   0   2 
  91	2   0   2 
  93	2   0   2 
  95	2   0   2 
  97	2   0   2 
  99	2   0   2 
 101	2   5   1 
 103	2   5   1 
 105	2   5   1 
 107	2   1   5 
 109	2   1   5 
 111	2   1   5 
