   1	2   7   4 
   3	2   7   4 
   5	2   7   4 
   7	6   3   1 
  13	2   6   3 
  15	2   6   3 
  17	2   6   3 
  19	2   7   6 
  21	2   7   6 
  23	2   7   6 
  13	6   5   1 
  19	2   1   0 
  21	2   1   0 
  23	2   1   0 
  25	2   0   3 
  27	2   0   3 
  29	2   0   3 
  31	2   0   6 
  33	2   0   6 
  35	2   0   6 
  37	2   0   6 
  39	2   0   6 
  41	2   0   6 
  43	2   1   4 
  45	2   1   4 
  47	2   1   4 
  49	2   3   1 
  51	2   3   1 
  53	2   3   1 
  55	2   7   4 
  57	2   7   4 
  59	2   7   4 
  61	2   3   4 
  63	2   3   4 
  65	2   3   4 
  67	2   3   4 
  69	2   3   4 
  71	2   3   4 
  73	2   7   1 
  75	2   7   1 
  77	2   7   1 
  79	6   6   0 
  85	2   7   6 
  87	2   7   6 
  89	2   7   6 
  85	2   0   1 
  87	2   0   1 
  89	2   0   1 
  91	2   3   7 
  93	2   3   7 
  95	2   3   7 
  97	2   1   4 
  99	2   1   4 
 101	2   1   4 
 103	2   0   6 
 105	2   0   6 
 107	2   0   6 
