   1	2   6   4 
   3	2   2   1 
   3	6   8   6 
   9	2   4   2 
  11	2   8   4 
  13	2   2   8 
  15	2   2   4 
  17	2   8   4 
  19	2   2   8 
  21	2   8   7 
  23	2   7   1 
  25	2   8   7 
  27	2   4   2 
  29	6   5   1 
  35	2   5   8 
  37	2   5   7 
  39	2   8   7 
  41	2   5   8 
  43	2   7   5 
