   1	2   1   5 
   1	6   6   3 
   7	2   3   1 
   7	6   8   7 
   9	2   0   2 
  11	6   2   0 
  17	2   5   3 
  19	2   5   1 
  21	2   3   1 
  23	2   5   3 
  25	2   1   5 
  27	2   1   3 
  29	2   7   1 
  31	2   3   7 
  33	2   3   1 
  35	2   7   1 
  37	2   3   7 
  39	2   1   3 
  41	2   1   2 
  43	2   0   1 
  45	2   0   2 
  47	2   1   2 
  49	2   0   1 
  51	2   1   3 
  53	2   7   1 
  55	2   3   7 
  57	2   3   1 
  59	2   7   1 
  61	2   2   0 
  63	2   3   7 
  65	2   1   3 
  67	2   2   0 
  69	2   1   2 
  71	2   0   1 
  73	2   0   2 
  75	2   1   2 
  77	2   0   1 
  79	2   1   5 
  81	2   3   1 
  83	2   5   3 
  85	2   5   1 
  87	2   3   1 
  89	2   5   3 
  91	2   1   5 
  93	2   1   3 
  95	2   7   1 
  97	2   3   7 
  99	2   3   1 
 101	2   7   1 
 103	2   2   0 
 105	2   3   7 
 107	2   1   3 
 109	2   2   0 
 111	2   1   2 
 113	2   0   1 
 115	2   0   2 
 117	2   1   2 
 119	2   0   1 
 121	2   1   3 
 123	2   7   1 
 125	2   3   7 
 127	2   3   1 
 129	2   7   1 
 131	2   2   0 
 131	6   7   6 
 133	2   2   0 
 137	2   3   6 
 139	2   1   3 
 141	2   1   2 
 143	2   0   1 
 145	2   0   2 
 147	2   1   2 
 149	2   0   1 
 151	2   2   0 
 153	2   3   0 
 155	2   6   3 
 155	2   1   5 
 157	2   0   6 
 159	2   0   3 
 161	2   6   3 
 163	2   0   6 
 165	2   3   0 
 167	2   3   1 
 169	2   5   3 
 171	2   5   1 
 173	2   3   1 
 175	2   5   3 
 177	2   3   0 
 179	2   6   3 
 179	2   1   5 
 181	2   0   6 
 183	2   0   3 
 185	2   6   3 
 185	2   1   5 
 187	2   0   6 
 189	2   3   0 
 191	2   3   1 
 193	2   5   3 
 195	2   5   1 
 195	6   7   6 
 197	2   2   0 
 199	6   2   0 
 205	2   3   1 
 207	2   5   3 
 209	2   1   5 
 211	2   1   5 
 213	2   3   1 
 215	2   5   3 
 217	2   5   1 
 219	2   3   1 
 221	2   5   3 
 223	2   1   5 
 225	2   1   3 
 227	2   7   1 
 229	2   3   7 
 231	2   3   1 
 233	2   7   1 
 235	2   3   7 
 237	2   1   3 
 239	2   1   0 
 241	2   2   1 
 243	2   2   0 
 245	2   1   0 
 247	2   2   1 
 249	2   1   3 
 251	2   7   1 
 253	2   3   7 
 255	2   3   1 
 257	2   7   1 
 259	2   0   2 
 261	2   3   7 
 263	2   1   3 
 265	2   0   2 
 267	2   1   0 
 269	2   2   1 
 271	2   2   0 
 273	2   1   0 
 275	2   2   1 
 277	2   1   5 
 279	2   3   1 
 281	2   5   3 
 283	2   5   1 
 285	2   3   1 
 287	2   5   3 
 289	2   1   5 
 291	2   1   3 
 293	2   7   1 
 295	2   3   7 
 297	2   3   1 
 299	2   7   1 
 301	2   0   2 
 303	2   3   7 
 305	2   1   3 
 307	2   0   2 
 309	2   1   0 
 311	2   2   1 
 313	2   2   0 
 315	2   1   0 
 317	2   2   1 
 319	2   1   3 
 321	2   7   1 
 323	2   3   7 
 325	2   3   1 
 327	2   7   1 
 329	2   0   2 
 331	2   3   7 
 333	2   1   3 
 335	2   0   2 
 337	2   1   0 
 339	2   2   1 
 341	2   2   0 
 343	2   1   0 
 345	2   2   1 
 347	2   1   5 
 349	2   3   1 
 351	2   5   3 
 353	2   5   1 
 355	2   3   1 
 357	2   5   3 
 359	2   1   5 
 361	2   1   3 
 363	2   7   1 
 365	2   3   7 
 367	2   3   1 
 369	2   7   1 
 371	2   0   2 
 373	2   3   7 
 375	2   1   3 
 377	2   0   2 
 379	2   1   0 
 381	2   2   1 
 383	2   2   0 
 385	2   1   0 
 387	2   2   1 
 389	2   1   3 
 391	2   7   1 
 393	2   3   7 
 395	2   3   1 
 397	2   7   1 
 399	2   0   2 
 401	2   3   7 
 403	2   1   3 
 405	2   0   2 
 407	2   1   0 
 409	2   2   1 
 411	2   2   0 
 413	2   1   0 
 415	2   2   1 
 417	2   1   5 
 419	2   3   1 
 421	2   5   3 
 423	2   5   1 
 425	2   3   1 
 427	2   5   3 
 429	2   1   5 
 431	2   1   3 
 433	2   7   1 
 435	2   3   7 
 437	2   3   1 
 439	2   7   1 
 441	2   0   2 
 443	2   3   7 
 445	2   1   3 
 447	2   0   2 
 449	2   1   0 
 451	2   2   1 
 453	2   2   0 
 455	2   1   0 
 457	2   2   1 
 459	2   1   3 
 461	2   7   1 
 463	2   3   7 
 465	2   3   1 
 467	2   7   1 
 469	2   0   2 
 469	6   7   6 
 471	2   0   2 
 475	2   3   6 
 477	2   1   3 
 479	2   1   0 
 481	2   2   1 
 483	2   2   0 
 485	2   1   0 
 487	2   2   1 
 489	2   0   2 
 491	2   3   0 
 493	2   6   3 
 493	2   1   5 
 495	2   0   6 
 497	2   0   3 
 499	2   6   3 
 501	2   0   6 
 503	2   3   0 
 505	2   3   1 
 507	2   5   3 
 509	2   5   1 
 511	2   3   1 
 513	2   5   3 
 515	2   3   0 
 517	2   6   3 
 517	2   1   5 
 519	2   0   6 
 521	2   0   3 
 523	2   6   3 
 523	2   1   5 
 525	2   0   6 
 527	2   3   0 
 529	2   3   1 
 531	2   5   3 
 533	2   5   1 
 533	6   7   6 
 535	2   0   2 
 539	2   3   1 
 541	2   5   3 
 543	2   1   5 
 545	2   1   5 
 547	2   3   1 
 549	2   5   3 
 551	2   5   1 
 553	2   3   1 
 555	2   5   3 
 557	2   1   5 
 559	2   1   3 
 561	2   7   1 
 563	2   3   7 
 565	2   3   1 
 567	2   7   1 
 569	2   3   7 
 571	2   1   3 
 573	2   1   0 
 575	2   2   1 
 577	2   2   0 
 579	2   1   0 
 581	2   2   1 
 583	2   1   3 
 585	2   7   1 
 587	2   3   7 
 589	2   3   1 
 591	2   7   1 
 593	2   0   2 
 595	2   3   7 
 597	2   1   3 
 599	2   0   2 
 601	2   1   0 
 603	2   2   1 
 605	2   2   0 
 607	2   1   0 
 609	2   2   1 
 611	2   1   5 
 613	2   3   1 
 615	2   5   3 
 617	2   5   1 
 619	2   3   1 
 621	2   5   3 
 623	2   1   5 
 625	2   1   3 
 627	2   7   1 
 629	2   3   7 
 631	2   3   1 
 633	2   7   1 
 635	2   0   2 
 637	2   3   7 
 639	2   1   3 
 641	2   0   2 
 643	2   1   0 
 645	2   2   1 
 647	2   2   0 
 649	2   1   0 
 651	2   2   1 
 653	2   1   3 
 655	2   7   1 
 657	2   3   7 
 659	2   3   1 
 661	2   7   1 
 663	2   0   2 
 665	2   3   7 
 667	2   1   3 
 669	2   0   2 
 671	2   1   0 
 673	2   2   1 
 675	2   2   0 
 677	2   1   0 
 679	2   2   1 
 681	2   0   2 
