   1	2   8   6 
   3	2   4   6 
   5	2   0   4 
   7	2   6   0 
   9	2   6   4 
  11	2   0   4 
  13	2   6   0 
  15	2   4   6 
  17	2   7   6 
  19	6   4   0 
  25	2   4   7 
  27	2   6   4 
  29	2   6   7 
  31	2   4   7 
  33	2   6   4 
  35	2   7   6 
  37	2   6   4 
