   1	2   7   1 
   3	2   4   2 
   5	2   4   5 
   7	2   2   4 
   9	2   5   2 
  11	2   5   4 
  13	2   2   4 
  15	2   5   2 
  17	2   4   5 
  19	2   4   7 
  21	2   1   4 
  23	2   1   7 
  25	2   4   7 
  27	2   1   4 
  29	2   7   1 
  31	2   7   1 
  33	2   4   5 
  35	2   2   4 
  37	2   5   2 
  39	2   5   4 
  41	2   2   4 
  43	2   5   2 
  45	2   4   5 
  47	2   4   7 
  49	2   1   4 
  51	2   1   7 
  53	2   4   7 
  55	2   1   4 
  57	2   2   4 
  59	2   7   1 
