   1	2   2   1 
   3	2   6   4 
   5	6   5   2 
   5	6   6   3 
  11	2   4   5 
  13	2   3   4 
  15	2   5   3 
  17	2   5   4 
  19	2   3   4 
  21	2   5   3 
  23	2   4   5 
  25	2   3   7 
  27	2   7   1 
  29	2   3   7 
  31	2   1   3 
  33	2   1   7 
  35	2   3   7 
  37	2   1   3 
  39	2   7   1 
