   1	2   1   4 
   3	6   1   0 
   9	2   1   5 
  11	2   4   5 
  13	2   7   4 
  15	2   5   7 
  17	2   5   4 
  19	2   7   4 
  21	2   5   7 
  23	2   4   5 
  25	2   5   4 
  27	2   4   7 
