   1	2   1   5 
   1	6   6   3 
   7	2   3   1 
   7	6   8   7 
   9	2   0   2 
  13	2   5   3 
  15	2   5   1 
  17	2   3   1 
  19	2   5   3 
  21	2   1   5 
  23	2   1   3 
  25	2   7   1 
  27	2   3   7 
  29	2   3   1 
  31	2   7   1 
  33	2   3   7 
  35	2   1   3 
  37	2   1   0 
  39	2   2   1 
  41	2   2   0 
  43	2   1   0 
  45	2   2   1 
  47	2   1   3 
  49	2   0   2 
  51	2   0   2 
  53	2   7   1 
  55	2   3   7 
  57	2   3   1 
  59	2   7   1 
  61	2   3   7 
  63	2   1   3 
  65	2   1   0 
  67	2   2   1 
  69	2   2   0 
  71	2   1   0 
  73	2   2   1 
  75	2   1   5 
  77	2   0   2 
  79	2   0   2 
  81	2   3   1 
  83	2   5   3 
  85	2   5   1 
  87	2   3   1 
  89	2   5   3 
  91	2   1   5 
  93	2   1   3 
  95	2   7   1 
  97	2   3   7 
  99	2   3   1 
 101	2   7   1 
 103	2   3   7 
 105	2   1   3 
 107	2   1   0 
 109	2   2   1 
 111	2   2   0 
 113	2   1   0 
 115	2   2   1 
 117	2   0   2 
 119	2   1   3 
 121	2   0   2 
 123	2   7   1 
 125	2   3   7 
 127	2   3   1 
 129	2   7   1 
 131	2   3   7 
 133	2   1   3 
 135	2   1   0 
 137	2   2   1 
 139	2   2   0 
 141	2   1   0 
 143	2   2   1 
 145	2   0   2 
 147	6   2   0 
 135	6   7   6 
 153	2   3   0 
 155	2   1   5 
 155	2   6   3 
 157	2   0   6 
 159	2   0   3 
 161	2   6   3 
 163	2   0   6 
 165	2   3   0 
 167	2   3   1 
 169	2   5   3 
 171	2   5   1 
 173	2   3   1 
 175	2   5   3 
 177	2   3   0 
 179	2   1   5 
 181	2   1   5 
 179	2   6   3 
 183	2   0   6 
 185	2   0   3 
 187	2   6   3 
 189	2   0   6 
 191	2   3   0 
 193	2   3   1 
 195	2   5   3 
 197	2   5   1 
 199	2   3   1 
 201	2   5   3 
 203	2   1   5 
 205	2   1   5 
 207	2   2   0 
 203	6   7   6 
 209	2   3   1 
 211	2   5   3 
 213	2   5   1 
 215	2   3   1 
 217	2   5   3 
 219	2   1   5 
 221	2   1   3 
 223	2   7   1 
 225	2   3   7 
 227	2   3   1 
 229	2   7   1 
 231	2   3   7 
 233	2   1   3 
 235	2   1   2 
 237	2   0   1 
 239	2   0   2 
 241	2   1   2 
 243	2   0   1 
 245	2   1   3 
 247	2   2   0 
 249	2   2   0 
 251	2   7   1 
 253	2   3   7 
 255	2   3   1 
 257	2   7   1 
 259	2   3   7 
 261	2   1   3 
 263	2   1   2 
 265	2   0   1 
 267	2   0   2 
 269	2   1   2 
 271	2   0   1 
 273	2   1   5 
 275	2   2   0 
 277	2   2   0 
 279	2   3   1 
 281	2   5   3 
 283	2   5   1 
 285	2   3   1 
 287	2   5   3 
 289	2   1   5 
 291	2   1   3 
 293	2   7   1 
 295	2   3   7 
 297	2   3   1 
 299	2   7   1 
 301	2   3   7 
 303	2   1   3 
 305	2   1   2 
 307	2   0   1 
 309	2   0   2 
 311	2   1   2 
 313	2   0   1 
 315	2   1   3 
 317	2   2   0 
 319	2   2   0 
 321	2   7   1 
 323	2   3   7 
 325	2   3   1 
 327	2   7   1 
 329	2   3   7 
 331	2   1   3 
 333	2   1   2 
 335	2   0   1 
 337	2   0   2 
 339	2   1   2 
 341	2   0   1 
 343	2   1   5 
 345	2   2   0 
 347	2   2   0 
 349	2   3   1 
 351	2   5   3 
 353	2   5   1 
 355	2   3   1 
 357	2   5   3 
 359	2   1   5 
 361	2   1   3 
 363	2   7   1 
 365	2   3   7 
 367	2   3   1 
 369	2   7   1 
 371	2   3   7 
 373	2   1   3 
 375	2   1   2 
 377	2   0   1 
 379	2   0   2 
 381	2   1   2 
 383	2   0   1 
 385	2   1   3 
 387	2   2   0 
 389	2   2   0 
 391	2   7   1 
 393	2   3   7 
 395	2   3   1 
 397	2   7   1 
 399	2   3   7 
 401	2   1   3 
 403	2   1   2 
 405	2   0   1 
 407	2   0   2 
 409	2   1   2 
 411	2   0   1 
 413	2   1   5 
 415	2   2   0 
 417	2   2   0 
 419	2   3   1 
 421	2   5   3 
 423	2   5   1 
 425	2   3   1 
 427	2   5   3 
 429	2   1   5 
 431	2   1   3 
 433	2   7   1 
 435	2   3   7 
 437	2   3   1 
 439	2   7   1 
 441	2   3   7 
 443	2   1   3 
 445	2   1   2 
 447	2   0   1 
 449	2   0   2 
 451	2   1   2 
 453	2   0   1 
 455	2   2   0 
 457	2   1   3 
 459	2   2   0 
 461	2   7   1 
 463	2   3   7 
 465	2   3   1 
 467	2   7   1 
 469	2   3   7 
 471	2   1   3 
 473	2   1   2 
 475	2   0   1 
 477	2   0   2 
 479	2   1   2 
 481	2   0   1 
 483	2   2   0 
 485	6   2   0 
 473	6   7   6 
 491	2   3   0 
 493	2   1   5 
 493	2   6   3 
 495	2   0   6 
 497	2   0   3 
 499	2   6   3 
 501	2   0   6 
 503	2   3   0 
 505	2   3   1 
 507	2   5   3 
 509	2   5   1 
 511	2   3   1 
 513	2   5   3 
 515	2   3   0 
 517	2   1   5 
 517	2   6   3 
 519	2   0   6 
 521	2   0   3 
 523	2   1   5 
 523	2   6   3 
 525	2   0   6 
 527	2   3   0 
 529	2   3   1 
 531	2   5   3 
 533	2   5   1 
 533	6   7   6 
 535	2   0   2 
 539	2   3   1 
 541	2   5   3 
 543	2   1   5 
 545	2   1   5 
 547	2   3   1 
 549	2   5   3 
 551	2   5   1 
 553	2   3   1 
 555	2   5   3 
 557	2   1   5 
 559	2   1   3 
 561	2   7   1 
 563	2   3   7 
 565	2   3   1 
 567	2   7   1 
 569	2   3   7 
 571	2   1   3 
 573	2   1   0 
 575	2   2   1 
 577	2   2   0 
 579	2   1   0 
 581	2   2   1 
 583	2   0   2 
 585	2   0   2 
 587	2   1   3 
 589	2   7   1 
 591	2   3   7 
 593	2   3   1 
 595	2   7   1 
 597	2   3   7 
 599	2   1   3 
 601	2   1   0 
 603	2   2   1 
 605	2   2   0 
 607	2   1   0 
 609	2   2   1 
 611	2   0   2 
 613	2   0   2 
 615	2   1   5 
 617	2   3   1 
 619	2   5   3 
 621	2   5   1 
 623	2   3   1 
 625	2   5   3 
 627	2   1   5 
 629	2   1   3 
 631	2   7   1 
 633	2   3   7 
 635	2   3   1 
 637	2   7   1 
 639	2   3   7 
 641	2   1   3 
 643	2   1   0 
 645	2   2   1 
 647	2   2   0 
 649	2   1   0 
 651	2   2   1 
 653	2   1   3 
 655	2   0   2 
 657	2   0   2 
 659	2   7   1 
 661	2   3   7 
 663	2   3   1 
 665	2   7   1 
 667	2   3   7 
 669	2   1   3 
 671	2   1   0 
 673	2   2   1 
 675	2   2   0 
 677	2   1   0 
 679	2   2   1 
 681	2   0   2 
