   1	2   0   3 
   3	2   3   6 
   5	2   6   4 
   7	2   3   0 
   9	2   4   1 
  11	2   6   3 
  13	2   1   7 
  15	2   4   6 
  17	2   7   5 
  19	2   1   4 
  21	2   7   1 
  23	2   5   7 
