   1	2   0   3 
   3	2   3   6 
   5	2   6   4 
   7	2   3   0 
   9	2   4   1 
  11	2   6   3 
  13	2   4   6 
  15	2   1   4 
