   1	2   0   3 
   3	2   3   6 
   5	2   6   4 
   7	2   4   1 
   9	2   1   7 
  11	2   3   0 
  13	2   6   3 
  15	2   4   6 
  17	2   1   4 
  19	2   7   1 
