   1	6   5   3 
   7	2   5   8 
   9	2   8   2 
  11	2   2   1 
  13	2   8   5 
  13	2   1   3 
  15	2   2   8 
  17	2   3   4 
  19	2   1   2 
  21	2   4   6 
  23	2   3   1 
  25	2   6   0 
  27	2   4   3 
  29	2   6   4 
  31	2   0   6 
