   1	2   5   3 
   3	6   5   3 
   9	2   5   8 
  11	2   8   6 
  11	6   2   1 
  17	2   5   3 
  19	2   8   5 
  19	6   3   1 
  25	2   6   3 
  25	6   2   1 
  27	2   6   8 
  31	2   3   1 
  33	2   1   4 
  35	2   3   6 
  37	2   1   3 
  39	2   4   1 
