   1	2  14   6 
   3	6   9   6 
   9	2   9  13 
   9	6   6   3 
  11	6  13   9 
  17	2   9   6 
  19	2  13  14 
  19	6   6   4 
  25	2   4  12 
  25	6   6   3 
  27	2   9  13 
  29	6  12   4 
  31	6   3   2 
  35	2  12   9 
  37	2   4   6 
  39	2   6   1 
  41	2   4  12 
  43	2   1   5 
  45	2   6   4 
  47	2   5   2 
  49	2   1   6 
  51	2   2   3 
  53	2   5   1 
  55	2   2   5 
  57	2   3   2 
