   1	2   6   7 
   3	2   7   4 
   5	2   4   5 
   7	2   7   6 
   7	2   5   1 
   9	2   4   7 
  11	2   1   0 
  13	2   5   4 
  15	2   1   5 
  17	2   0   1 
