   1	2   0   3 
   3	2   3   5 
   5	2   5   4 
   7	2   3   0 
   9	2   4   7 
  11	2   5   3 
  13	2   7   8 
  13	6   3   1 
  19	2   4   5 
  21	2   8   6 
  21	6   2   1 
  23	2   6   3 
  27	2   7   4 
  29	2   8   7 
  29	2   3   1 
  31	2   6   8 
  33	2   3   6 
  35	2   1   3 
