   1	2   4   1 
   3	2   1   7 
   5	2   7   5 
   7	2   5   2 
   9	2   1   4 
  11	2   7   1 
  13	2   5   7 
  15	2   2   5 
