   1	2   0   3 
   3	2   3   5 
   5	2   5   4 
   7	2   4   7 
   9	2   7   8 
   9	2   3   0 
  11	2   8   6 
  11	6   1   0 
  17	2   6   0 
  19	2   5   3 
  21	2   4   5 
  23	2   7   4 
  25	2   0   2 
  25	2   8   7 
  27	2   6   8 
  29	2   0   6 
  31	2   2   0 
