   1	6   8   4 
   7	2   3   4 
   9	2   4   2 
  11	2   2   1 
  13	2   1   5 
  15	2   5   8 
  17	2   4   3 
  19	2   2   4 
  21	2   8   6 
  21	2   1   2 
  23	2   5   1 
  25	2   6   0 
  25	2   8   5 
  27	2   6   8 
  29	2   0   6 
