   1	2   5   3 
   3	6   8   6 
   9	2   3   6 
  11	2   6   8 
  13	2   3   5 
  15	2   8   2 
  17	2   2   1 
  15	2   6   3 
  17	2   8   6 
  19	2   1   4 
  21	2   2   8 
  23	2   1   2 
  25	2   4   1 
