   1	2   0   3 
   3	2   3   6 
   5	2   6   4 
   7	2   4   1 
   9	2   1   7 
