   1	2  14   6 
   3	6   9   6 
   9	2   9  13 
   9	6   6   3 
  11	6  13   9 
  17	2   9   6 
  19	6   9   6 
  25	2   9  12 
  25	6   3   1 
  27	6  12   9 
  31	6   3   2 
  33	6   9   4 
  37	6  11   3 
  39	2   4   1 
  43	2   1   2 
  45	2   2   5 
  47	2   5   9 
  49	2   9  11 
