   1	2   5   3 
   3	6   5   3 
   9	2   5   8 
  11	2   8   6 
  11	6   2   1 
  13	6   6   3 
  19	2   3   1 
  21	2   1   2 
  23	2   2   4 
