   1	2   0   3 
   3	2   3   5 
   5	2   5   4 
   7	2   4   7 
   9	2   7   8 
   9	6   3   1 
  15	2   8   6 
  15	6   2   1 
  17	2   6   3 
  21	2   3   1 
