   1	2   5   3 
   3	6   8   6 
   9	2   3   6 
  11	2   6   8 
  13	2   8   2 
  15	2   2   1 
  17	2   1   4 
