   1	6   4   3 
   7	2   4   8 
   9	2   8   2 
  11	2   2   1 
  13	2   1   5 
  15	2   5   3 
  17	2   3   6 
  19	2   6   0 
