   1	2   6   7 
   3	2   7   4 
   5	2   4   5 
   7	2   5   1 
   9	2   1   0 
