   1	2   2   7 
   1	6  13   9 
   3	6   4   1 
   3	6   7   3 
   9	2   6   9 
  11	2   6   5 
  13	2   2  10 
  15	2   5   0 
  17	2   9   4 
  17	6   7   2 
  15	6  15  14 
  21	2  10  14 
  23	2   3   1 
  23	6  14  10 
  25	2   0   2 
  27	2   1   4 
  29	2   2  10 
