   1	2   2   5 
   3	2   5   1 
   5	2   2   4 
   7	2   7   1 
   9	2   7   4 
