   1	2   0   6 
   3	2   0   4 
   5	2   5   1 
   5	6   7   6 
  11	2   4   8 
  13	2   5   3 
  15	2   1   3 
  17	6   4   2 
  23	2   7   4 
  25	2   4   8 
