   1	2   4   1 
   3	2   6   8 
   5	2   4   2 
   7	2   1   2 
   7	6   8   6 
  13	2   8   5 
  13	2   6   3 
  15	2   3   5 
