   1	2   0   1 
   3	2   0   4 
   5	2   5   4 
   7	2   5   7 
   9	6   3   1 
  15	2   3   6 
  17	2   7   6 
