   1	2   2   5 
   3	2   2   4 
   5	2   5   1 
   7	2   7   1 
   9	2   7   4 
