   1	2   5   1 
   3	2   0   6 
   5	2   0   4 
   7	2   5   3 
   9	6   5   2 
   9	6   7   6 
  15	2   7   5 
  17	2   4   8 
  19	2   1   3 
  19	2   5   8 
