   1	2   4   1 
   3	2   4   2 
   5	2   1   2 
   5	2   6   8 
   7	6   5   3 
  13	2   6   3 
  13	2   8   5 
  15	2   5   3 
