   1	2   2   1 
   1	6   7   3 
   7	2   3   4 
   9	2   4   7 
  11	2   2   8 
  11	2   3   0 
  13	2   5   7 
  13	6   1   0 
  19	2   0   6 
  21	2   6   8 
  23	2   5   1 
