   1	2   0   4 
   3	2   3   4 
   5	2   6   4 
   7	2   1   4 
   9	2   7   4 
  11	2   2   4 
  13	2   5   4 
  15	2   8   4 
