   1	2   0   5 
   3	2   4   5 
   5	2   8   5 
   7	2   1   5 
   9	2   9   5 
  11	2  13   5 
  13	2   2   5 
  15	2   6   5 
  17	2  10   5 
  19	2   7   5 
