   1	2   0   5 
   3	2   4   5 
   5	2   8   5 
   7	2   1   5 
   7	6  12   8 
  13	2   9   5 
  15	2  13   5 
  17	2   2   5 
  19	2   6   5 
  21	2  10   5 
  23	2   7   5 
  25	2   8   5 
