   1	2   0   3 
   3	2   6   3 
   5	2   1   3 
   7	2   4   3 
   9	2   7   3 
  11	2   5   3 
